MySpaceは、米国で3番目に人気のあるウェブサイトで、現在5千4百万人のプロフィールが存在します。	MySpace is the third most popular website used in the United States and has 54 million profiles currently.
こういったウェブサイトは特に教育環境において大いに注目を集めています。	These websites have gotten a lot of attention, especially in the education setting.
これらのウェブサイトは、特に教育現場で多くの注目を集めています。ブログ、動画、写真、その他の機能を盛り込んだクラスページを簡単に設定することができるなどの優れた側面があります。	There are positive aspects to these websites, which include, being able to easily setup a class page which can include blogs, videos, photos, and other features.
このページは、ウェブアドレスを1つ入力するだけで簡単にアクセスでき、キーボードの使用や複雑な綴りが苦手な学生にとって覚えやすく、入力しやすい仕様になっています。	This page can easily be accessed by providing just one web address, which makes it easy to remember and easy to type in for students who may have trouble using the keyboard or with spelling.
読みやすくカスタマイズしたり、表示色を自由に増減できます。	It can be customized to make it easy to read and also with as much or little color as desired.
注意力欠如障害とは、「神経学的症候群であり、その古典的定義は衝動性、注意力散漫、多動またはエネルギー過多の3つの症状です。	Attention Deficit Disorder "is a neurological syndrome whose classic defining triad of symptoms including impulsivity, distractibility, and hyperactivity or excess energy".
これは教育的な意味での学習障害ではなく、医学的な意味での学習障害であり、すべての子供の3～5%、おそらく200万人ものアメリカ人の子供に影響を与えています。	It is not a learning disability, it is a learning disorder; it "affects 3 to 5 percent of all children, perhaps as many as 2 million American children".
ADDを持つ子供は、学校の勉強などに集中することは難しいものの、ゲームをしたり、好きなアニメを見たり、句読点のない文章を書いたりするような、楽しいことには集中できるのです。	Children with ADD have a hard time focusing on things like school work, but they can concentrate on things they enjoy doing like playing games or watching their favorite cartoons or writing sentences without punctuation.
こういった子供たちは、通常の方法では脳が刺激されないため、脳を刺激しようとして「危険な行動に出たり、喧嘩をしたり、権威にたて突いたり」して、さまざまなトラブルに巻き込まれる傾向があります。	These children tend to get into a lot of trouble, because they "engage in risky behaviors, get into fights, and challenge authority" in order to stimulate their brain, since their brain can not be stimulated by normal methods.
ADDは仲間との関係に影響を及ぼします。ADDを持つ子がなぜそのように振る舞い、なぜそのように字を綴り、なぜ成熟度が違うのかを他の子供たちは理解できないためです。	ADD affects relationships with other peers because other children can not understand why they act the way that they do or why they spell they way they do or that their maturity level is different.
この活動を見た入植者たちも増援を要請していた。	The Colonists, seeing this activity, had also called for reinforcements.
前方陣地を補強する部隊には、ジョン・スターク大佐とジェームズ・リード大佐（ともに後に将軍となる）の下で200人からなるニューハンプシャー第1連隊と第3連隊が動員されていました。	Troops reinforcing the forward positions included the 1st and 3rd New Hampshire regiments of 200 men, under Colonels John Stark and James Reed (both later became generals).
スタークの兵士たちは入植者陣地の北端側フェンス沿いに陣地を構えました。	Stark's men took positions along the fence on the north end of the Colonist's position.
干潮時に半島の北東に沿ってミスティック川に沿って隙間が開くと、彼らはすかさず、狭い海岸の北端まで低い石垣でフェンスを拡張しました。	When low tide opened a gap along the Mystic River along the northeast of the peninsula, they quickly extended the fence with a short stone wall to the north ending at the water's edge on a small beach.
グリッドリーまたはスタークは外柵の前方約100フィート(30 m)の位置に杭を打ち、正規軍がそこを通過するまで誰も発砲しないようにと命令しました。	Gridley or Stark placed a stake about 100 feet (30 m) in front of the fence and ordered that no one fire until the regulars passed it.
アメリカの計画は、異なる3方向から協調攻撃を開始するというものでした。	The American plan relied on launching coordinated attacks from three different directions.
ジョン・カドワルダー将軍は、敵の増援を阻止するために、ボーデンタウンにある英国軍駐屯地に向けて陽動攻撃を開始しました。	General John Cadwalder would launch a diversionary attack against the British garrison at Bordentown, in order to block off any reinforcements.
ジェームズ・ユーイング将軍は、トレントン軽巡洋艦で民兵700人を連れて川を渡り、アサンピンク・クリークにかかる橋を奪取し、敵軍の逃亡を阻止しました。	General James Ewing would take 700 militia across the river at Trenton Ferry, seize the bridge over the Assunpink Creek and prevent any enemy troops from escaping.
2,400人の主力突撃部隊は、トレントンの北9マイルの地点で川を渡り、グリーン指揮下とサリヴァン指揮下の2つの部隊に分かれ、夜明け前の攻撃を開始しました。	The main assault force of 2,400 men would cross the river nine miles north of Trenton, and then split into two groups, one under Greene and one under Sullivan, in order to launch a pre-dawn attack.
プロジェクトベースの学習で学習はより簡単かつ興味深いものになるはずですが、スキャフォールディングはその1歩先を行きます。	While project based learning should make learning easier and more interesting, scaffolding goes a step beyond.
スキャフォールドは学習の方法ではなく、新しいコンピュータプログラムを使ったり、新しいプロジェクトを開始したり、新しい学習体験をしている人をサポートするためのものです。	Scaffolding is not a method of learning but rather an aid that provides support to individuals whom are undergoing a new learning experience such as using a new computer program or beginning a new project.
スキャフォールディングにはバーチャルとリアルの両方があります。言い換えれば、教師はスキャフォールディングの一形態であり、Microsoft Officeのクリップ人形もそうです。	Scaffolds can be both virtual and real, in other words, a teacher is a form of scaffold but so is the little paperclip man in Microsoft Office.
バーチャル・スキャフォールドはこのソフトウェアに組み込まれており、学生が1人では難しいと思われる手順についての質問、指示、説明できるようにすることを目的としています。	Virtual Scaffolds are internalized in the software and are meant to question, prompt, and explain procedures that may have been to challenging for the student to handle alone.
子供たちが里親制度に預けられる理由は、育児放棄から虐待、さらには恐喝に至るまでさまざまです。	Children are placed in Foster Care for a wide variety of reasons that range from neglect, to abuse, and even to extortion.
どんな子供も養育、世話、教育の整った環境で育つべきですが、野生児はそれがない環境で育っているのです。	No child should ever have to grow up in an environment that is not nurturing, caring, and educational, but they do.
里親制度とは、こうした子供たちの安全地帯であると私たちは認識しています。	We perceive the Foster Care System to be a safety zone for these children.
里親制度では、安全な家庭、愛情ある育児、確かな教育、信頼できる医療を提供することになっています。	Our foster care system is supposed to provide safe homes, loving caregivers, stable education, and reliable health care.
里親制度では、引き取られる前の家庭で不足していたあらゆる必需品を提供することになっています。	Foster care is supposed to provide all the necessities that were lacking in the home they were previously taken from.
7月4日に議会で採択された後、ジョン・ハンコック大統領とチャールズ・トムソン長官が署名した手書きの草案が、数街区先のジョン・ダンラップ社の印刷所に送られました。	After its adoption by Congress on July 4, a handwritten draft signed by the President of Congress John Hancock and the Secretary Charles Thomson was then sent a few blocks away to the printing shop of John Dunlap.
一晩で150～200枚が複製され、現在では「ダンラップ・ブロードサイド」と呼ばれています。	Through the night between 150 and 200 copies were made, now known as "Dunlap broadsides".
この文書の初の公開朗読は、7月8日に独立記念館の庭でジョン・ニクソンによって行われました。	The first public reading of the document was by John Nixon in the yard of Independence Hall on July 8.
1通は7月6日にジョージ・ワシントンに送られ、7月9日にニューヨークで軍隊に向けて朗読されました。もう1通は8月10日にロンドンに届きました。	One was sent to George Washington on July 6, who had it read to his troops in New York on July 9. A copy reached London on August 10.
現存することが知られている25枚のダンラップ・ブロードサイドは、現存する当該文献の最古の写しです。手書きによる原本は現存していません。	The 25 Dunlap broadsides still known to exist are the oldest surviving copies of the document. The original handwritten copy has not survived.
