そうです！ツタンカーメン王は、「少年王」と呼ばれることもあり、現代では最も有名な古代エジプトの王の1人です。	Yes! King Tutankhamun, sometimes referred to as "King Tut" or "The Boy King", is one of the most well known ancient Egyptian kings in modern times.
興味深いことに、彼は古代ではあまり重視されておらず、ほとんどの古代の王の名簿には記録がありません。	Interestingly, he was not considered to be very important in ancient times and was not recorded on most ancient king lists.
しかし、1922年に墓が発見されたことで、この若い王は一躍有名になりました。先人たちの墓の多くが墓荒らしに遭う中、この墓はほとんど手をつけかずで残っていたのです。	However, the discovery of his tomb in 1922 made him a celebrity. While many tombs of the past were robbed, this tomb was left virtually undisturbed.
ツタンカーメンと一緒に埋葬された品目のほとんどは良い状態で保存されており、貴金属や希少な石で作られた工芸品などが何千とありました。	Most of the items buried with Tutankhamun have been well preserved, including thousands of artefacts made from precious metals and rare stones.
スポーク式ホイールの発明により、アッシリア軍の戦車は軽量、高速、強力になり、他国の兵士や戦車を振り切る体制が整いました。	The invention of spoke wheels made Assyrian chariots lighter, faster, and better prepared to outrun soldiers and other chariots.
恐ろしいクロスボウから放たれる矢は、敵兵の鎧を貫通しました。紀元前1000年頃にアッシリア人は最初の騎兵隊を導入した。	Arrows from their deadly crossbows could penetrate the armor of rival soldiers. About 1000 B.C., the Assyrians introduced the first cavalry.
騎馬隊は、馬に乗って戦う軍隊です。当時まだ鞍や鐙は発明されていなかったため、アッシリアの騎兵たちは、馬の裸の背にまたがって戦いました。	A cavalry is an army that fights on horseback. The saddle had not yet been invented, so the Assyrian cavalry fought on the bare backs of their horses.
有名なギリシャ人の政治家、科学者、芸術家は大勢います。この古代文化の担い手としておそらく最も有名なのは、ギリシャ文学の2大傑作であるイリアスとオデュッセイアを作曲した伝説の盲目詩人ホメロスでしょう。	We know many Greek politicians, scientists, and artists. Possibly the most known person of this culture is Homer, the legendary blind poet, who composed two masterpieces of Greek literature: the poems Iliad and Odyssey.
ソフォクレスやアリストファネスは、今でも人気の劇作家であり、彼らの戯曲は世界文学の最高傑作と称えられています。	Sophocles and Aristophanes are still popular playwrights and their plays are considered to be among the greatest works of world literature.
もう1人の有名なギリシャ人は数学者ピタゴラスで、主に直角三角形の辺の関係についての有名な定理を発見したことで知られています。	Another famous Greek is a mathematician Pythagoras, mostly known for his famous theorem about relations of the sides of right triangles.
彼らの食べ物のほとんどは私たちに馴染みのあるものですが、ローマ人はイノシシ、孔雀、カタツムリ、そしてネズミと呼ばれる齧歯類の一種など、下手物や珍味を食していました。	While most of their food would be familiar to us, Romans did have their share of strange or unusual feast items, including wild boar, peacock, snails, and a type of rodent called a dormouse
もう1つの違いは、貧しい人々や女性は椅子に座って食事をするのに対し、金持ちの男性は寝そべってくつろぎながら食事をする宴会を好んだということです。	Another difference was that while the poor people and the woman ate their food while sitting in chairs, the rich men liked to have banquets together where they would lounge on their sides while they ate their meals.
古代ローマの食事には、後の数世紀の間にアメリカやアジアから欧州に渡ってきた食材が取り入れられたはずはありません。	Ancient Roman meals couldn't have included foods that came to Europe from America or from Asia in later centuries.
例えば、そこにはトウモロコシもトマトもジャガイモもココアもなく、七面鳥を味わった古代ローマ人はいなかったわけです。	For instance, they didn't have corn, nor tomatoes, nor potatoes, nor cocoa, and no ancient Roman ever tasted a turkey.
バビロニア人は、神々のそれぞれに第一神殿を建て、それは神々の家とみなされていました。	The Babylonians built each of their gods a primary temple that was considered the home of the god.
人々は神々に生け贄を捧げ、祭司は儀式や祭りを通して神々の望みに応えようとしました。	People would bring sacrifices to the gods and the priests would try to attend to the needs of the gods through ceremonies and festivals.
各寺院には、開放的な中庭があり、その後に神官のみが入れる内宮がありました。	Each temple had an open temple courtyard and then an inner sanctuary that only the priests could enter.
寺院の一部として、ジグラットと呼ばれるピラミッド型の特殊な塔が建てられることがありました。	Sometimes special pyramid shaped towers, called ziggurats, were built to be a part of the temples.
塔の最上部は神のための特別な聖域でした。	The top of the tower was special sanctuary for the god.
中東の温暖な気候に暮らす人々にとって家屋はそれほど重要ではありませんでした。	In the warm climate of the Middle East, the house was not so important.
ヘブライ人家族はほとんど戸外で暮らしていました。	Most of the life of the Hebrew family happened in the open air.
女性たちが庭で調理をし、店はいずれも街路に面した屋台に過ぎませんでした。家の建築には石が使われていました。	Women did the cooking in the yard; stores were just open counters looking into the street. Stone was used for building houses.
カナンの地には大規模な森林が存在しなかったので木材は非常に高価で貴重なものでした。	There were no large forests in the land of Canaan, so wood was extremely expensive.
グリーンランドは過疎な地域でした。北欧の伝承によれば、赤毛のエイリークが殺人罪でアイスランドから追放され、西に向かったときにグリーンランドを発見して、グリーンランドと名付けたとされます。	Greenland was settled sparsely. In the Norse sagas they say that Erik the Red was exiled from Iceland for murder, and when travelling further west, found Greenland and named it Greenland.
しかし、彼の発見とは関係なく、当時すでにエスキモー部族はそこに住んでいました。	But regardless of his discovery, Eskimo tribes were already living there at the time.
どの国も「スカンジナビア」であることは変わりませんが、デンマーク、スウェーデン、ノルウェー、アイスランドの国民性、王制、風習、歴史には相当な違いがあったのです。	Though each country was 'Scandinavian', there were many differences between the people, kings, customs and history of Denmark, Sweden, Norway and Iceland.
文明とは、共同で生活や仕事を営む人々の大集団が共有する1つの文化、つまり社会のことです。	A civilization is a singular culture shared by a significant large group of people who live and work co-operatively, a society.
文明という言葉は、市民を意味するラテン語の形容詞civilisから来ており、市民を意味するラテン語の名詞civis、都市や都市国家を意味し、何らかの形で社会の規模を定義するcivitasという名詞に関係しています。	The word civilization comes from the Latin civilis, meaning civil, related to the Latin civis, meaning citizen, and civitas, meaning city or city-state, and that also somehow defines the size of the society.
都市国家は国家の前身です。文明文化とは、数世代にわたる知識の継承、文化的足跡の存続、公正な普及を意味します。	City-states are the precursors of nations. A civilizational culture implies the passing on of knowledge across several generations, a lingering cultural footprint and fair dissemination.
主流からはずれた文化は、正式な文明として認識されないまま消滅することが多く、そうすると歴史的証拠は残りません。	Minor cultures often vanish without leaving relevant historic evidence and fail to be recognized as proper civilizations.
古代中国には、時代差を示す独自の方法があり、中国史における各段階、または権力を握っていた一族が特徴的な王朝となりました。	Ancient China had a unique way of showing different time periods; each stage of China or each family that was in power was a distinctive dynasty.
また、各王朝の間には、分断された地方の不安定な時代がありました。これらの時代のうち最もよく知られているのは、漢と晋の時代に挟まれ、60年間にわたって続いた三国時代です。	Also between each dynasty was an unstable age of divided provinces. The best-known of these periods was the Three Kingdoms epoch taking place for 60 years between the Han and the Jin Dynasty.
こうした時代には、王位をめぐって多くの貴族たちが激しい戦いを繰り広げていました。	During these periods fierce warfare took place between many nobles fighting for the throne.
三国志は、古代中国の歴史の中で最も血なまぐさい時代の1つでした。西安の大宮殿の最高位を狙う争いの中で何千人もが戦士しました。	The Three Kingdoms was one of the bloodiest eras in Ancient China’s history thousands of people died fighting to sit in the highest seat in the grand palace at Xi’an.
