「パナマ文書とは」、2016年春にパナマの法律事務所モサック・フォンセカから報道機関に流出した脱税行為に関する書類の総称で、その総数はおよそ1000万件です。	"Panama Papers" is an umbrella term for roughly ten million documents from Panamanian law firm Mossack Fonseca, leaked to the press in spring 2016.
文書には、富裕層の顧客が税金等の規制を逃れて数十億ドルの資産を隠す際に14の銀行が手助けしたことが示されています。	The documents showed fourteen banks helped wealthy clients hide billions of US dollars of wealth to avoid taxes and other regulations.
英国のガーディアン紙は、ドイツ銀行が1200社のペーパーカンパニーの約3分の1を支配していることを示唆しました。	British newspaper The Guardian suggested Deutsche Bank controlled roughly a third of the 1200 shell companies used to accomplish this.
世界中で抗議の声が上がり、何件もの刑事告発があり、アイスランドとパキスタンの両政府の指導者が辞任しました。	There were protests worldwide, several criminal prosecutions, and the leaders of the governments of Iceland and Pakistan both resigned.
イラクのアブ・グライブ刑務所が暴動の最中に放火されました。	Iraq's Abu Ghraib prison has been set alight during a riot.
米軍による占領後、囚人の虐待が発覚し、当該刑務所の悪名がとどろきました。	The jail became notorious after prisoner abuse was discovered there after US forces took over.
ピケJr.は2008年のシンガポールGPで、フェルナンド・アロンソが早めにピットインした直後にクラッシュし、セーフティーカーが導入されました。	Piquet Jr. crashed in the 2008 Singapore Grand Prix just after an early pit stop for Fernando Alonso, bringing out the safety car.
先行するマシンがセーフティカーの後ろで燃料を補給する中、アロンソは集団の中で順位を上げて勝利を手にしました。	As the cars ahead of Alonso went in for fuel under the safety car, he moved up the pack to take victory.
ピケJr.は2009年のハンガリーGP後に解雇されました。	Piquet Jr. was sacked after the 2009 Hungarian Grand Prix.
過去3カ月間に、80人以上の逮捕者が正式に起訴されることなくセントラルブッキング施設から釈放されました。	In the last 3 months, over 80 arrestees were released from the Central Booking facility without being formally charged.
今年4月には、グリン判事が同施設に対して、収容後24時間以上経過しても裁判所の委員による審問を受けなかった者の釈放を強制するための仮処分命令を発令しました。	In April this year, a temporary restaining order was issued by Judge Glynn against the facility to enforce the release of those held more than 24 hours after their intake who did not receive a hearing by a court commissioner.
コミッショナーは、保釈が認められた場合には保釈金を定め、逮捕した警官により申請された嫌疑を正式なものにします。その後、嫌疑内容は州のコンピューターシステムに入力され、事件が追跡されます。	The commissioner sets bail, if granted, and formalizes the charges filed by the arresting officer. The charges are then entered into the state's computer system where the case is tracked.
聴聞会では、迅速な裁判を受ける被疑者の権利に基づき期日を示します。	The hearing also marks the date for the suspect’s right to a speedy trial.
ANSAによると、「警察は、本格的な後継者争いに火がつくのを恐れていた最上層部たちによる抗争が2～3回あるだろうと懸念していた」そうです。	According to Ansa, "police were concerned by a couple of top-level hits they feared might spark a full-blown war of succession.
警察によると、ロ・ピッコロはパレルモでプロヴェンツァーノの右腕として活躍していたことと、権力網を強化している間はできるだけ目立たないようにというプロヴェンツァーノの方針に従っていたため、その優れた経験が年配幹部たちから尊敬を集めたことで有利な状況にあるとのことです。	Police said Lo Piccolo had the upper hand because he had been Provenzano's right-hand man in Palermo and his greater experience won him the respect of the older generation of bosses as they pursued Provenzano's policy of keeping as low as possible while strengthening their power network.
「1992年にマフィア撲滅運動家ジョヴァンニ・ファルコーネとパオロ・ボルセリーノの命を奪ったリイナ主導の国家との戦争に終止符を打ったとき、これらの幹部たちはプロヴェンツァーノによって抑え付けられていました。」	These bosses had been reined in by Provenzano when he put an end to the Riina-driven war against the state that claimed the lives of Mafia crusaders Giovanni Falcone and Paolo Borsellino in 1992."
ブラジルは地球上で最大のローマ・カトリックの国であり、ローマ・カトリック教会は一貫して同性婚の合法化に反対してきた。	Brazil is the largest Roman Catholic country on Earth, and the Roman Catholic Church has consistently opposed the legalization of same-sex marriage in the country.
ブラジルの全国議会では10年前から合法化を巡る議論が続いており、そのような民事婚は現在、リオグランデ・ド・スル州でのみ合法化されています。	The National Congress of Brazil has debated legalization for 10 years, and such civil marriages are currently only legal in Rio Grande do Sul.
法案の原案は、元サンパウロ市長のマルタ・スプリシー氏によって起草された。提案された法案は、修正された後、ロベルト・ジェファーソンの手に渡りました。	The original bill was drafted by former mayor of São Paulo, Marta Suplicy. The proposed legislation, after being amended, is now in the hands of Roberto Jefferson.
抗議者たちは、120万人の署名を集めて11月の全国大会に提出しようと考えています。	Protesters hope to collect a petition of 1.2 million signatures to present to the National Congress in November.
多くの家族が立ち退きと戦うために法的支援を求めていることが明らかになった後、3月20日、東海岸地域法律相談所で住宅詐欺の被害者のための集会が開催されました。	After it became apparent that many families were seeking legal help to fight the evictions, a meeting was held on March 20 at the East Bay Community Law Center for the victims of the housing scam.
入居者が状況を共有し始めた頃、関係する家族のほとんどが突然気づいたのは、OHAのキャロリン・ウィルソンが自分たちの保証金を盗んで町を飛び出したということでした。	When the tenants started sharing what had occurred to them, most of the families involved suddenly realized that Carolyn Wilson of the OHA had stolen their security deposits, and skipped out of town.
ロックウッド・ガーデンズの入居者は、OHA警察がこの住宅詐欺に巻き込まれた可能性のあるオークランドの他の公営住宅も調査していることを知ったので、さらに40世帯以上が立ち退きに直面する可能性があると考えています。	Tenants at Lockwood Gardens believe that there may be another 40 families or more to face eviction, since they learned that OHA police are also investigating other public housing properties in Oakland that may be caught up in the housing scam.
バンドはマウイ島の戦争記念スタジアムで90,000人を集客する予定でしたが、その公演をキャンセルし、ファンに謝罪しました。	The band canceled the show at Maui's War Memorial Stadium, which was set to be attended by 9,000 people, and apologized to fans.
このバンドの運営会社であるHKマネジメントは、9月20日公演の中止時に当初理由を明かさなかったが、翌日までには物流上の理由を非難しました。	The band's management company, HK Management Inc., gave no initial reason when they canceled on September 20, but blamed logistical reasons by the next day.
サキス・ケチャジオグルとジョージ・ニコラコプロスは、いずれもギリシャの有名な弁護士ですが、接収と汚職の罪でアテネのコリダロス刑務所に入っています。	The famous Greek lawyers, Sakis Kechagioglou and George Nikolakopoulos have been imprisoned in the Athens' jail of Korydallus, as they were found guilty of graft and corruption.
その結果、過去数年間に裁判官、法律家、法務官士、弁護士が犯した違法行為が暴露され、ギリシャ法曹界で大いに物議を醸しています。	As a result of this, a big scandal within the Greek legal community has been raised through the exposure of illegal actions that judges, lawyers, solicitors and attorneys have done during the previous years.
数週間前にジャーナリストのマキス・トリアンタフィロプロス氏がアルファテレビの人気番組「Zoungla」で公開した情報を受けて、国会議員で弁護士のペトロス・マントゥバロス氏は、所属事務所のメンバーが違法な接待や汚職に関与していたとして退任させられました。	A few weeks ago, after the information published by the journalist Makis Triantafylopoulos in his popular Television show "Zoungla" in Alpha TV, the member of Parliament and lawyer, Petros Mantouvalos was abdicated as members of his office had been involved in illegal graft and corruption.
しかも、最高裁判事エヴァンゲロス・カルーシスは、汚職と不正行為により有罪となり、投獄されています。	Moreover, top judge Evangelos Kalousis is imprisoned as he found guilty of corruption and degenerate behaviour.
今日、レッドレイクコミュニティでは、ジェフ・ウェイズと9人の犠牲者のうち3人の葬儀が執り行われている最中に、3月21日に発生した学校での銃撃に関連してもう1人の学生が逮捕されたというニュースが広まりました。	News spread in the Red Lake community today as funerals for Jeff Weise and three of the nine victims were held that another student was arrested in connection with the school shootings of March 21.
当局は、本日の逮捕を認めたこと以外にほとんど公式な発言をしていません。	Authorities said little officially beyond confirming today's arrest.
しかし、捜査に詳しい情報筋がミネアポリス・スター・トリビューン紙に語ったところによると、犯人はレッドレイク部族会長フロイド・ジュルダンの16歳の息子、ルイ・ジュルダンだったということです。	However, a source with knowledge of the investigation told the Minneapolis Star-Tribune that it was Louis Jourdain, 16-year old son of Red Lake Tribal Chairman Floyd Jourdain.
現時点では、どのような容疑がかけられているのか、当局が少年をのような経緯で逮捕したのかは不明ですが、連邦裁判所で少年に対する手続きが始まっています。	It is not known at this time what charges will be laid or what led authorities to the boy but juvenile proceedings have begun in federal court.
ロサンゼルス警察の広報担当者クリストファー・ガルシア氏によると、この男性容疑者は、破壊行為ではなく不法侵入で捜査されているということです。	Christopher Garcia, a spokesperson of the Los Angeles Police Department, said the suspected male offender is being investigated for trespassing rather than vandalism.
看板に物理的な破損はなく、「O」を小文字の「e」と読めるようにして平和とハートが飾った黒い防水シートで改修されました。	The sign was not physically damaged; the modification was done using black tarpaulins decorated with signs of peace and heart to alter the "O" to read lowercase "e".
この裁判はバーミンガム刑事法院で行われ、8月3日に結審しました。	The trial took place at Birmingham Crown Court and concluded on August 3.
現場で逮捕された司会者は暴行を否認し、最大30人から瓶を投げつけられたため、身を守るために棒を使ったと主張しています。	The presenter, who was arrested at the scene, denied the attack and claimed he used the pole to protect himself from bottles being thrown at him by up to thirty people.
ブレイクはまた、正義の道を踏み外した罪で有罪判決を受けました。	Blake was also convicted of attempting to pervert the course of justice.
裁判官は、ブレイクの刑務所送りは「ほとんど避けられない」と言いました。	The judge told Blake it was "almost inevitable" he was going to be sent to jail.
男は爆発物を積んだ三輪自動車で群衆に突っ込んだと報じられています。	The man allegedly drove a three-wheeled vehicle armed with explosives into a crowd.
爆弾を爆発させた疑いのある男は、爆風で負傷した後、拘留された。	The man suspected of detonating the bomb was detained, after sustaining injuries from the blast.
当局は彼がウイグル族の一員であることを突きとめたものの、まだ名前までは把握していません。	His name is still unknown to authorities, although they do know he is a member of the Uighur ethnic group.
問題の発端は1月1日、地元住民数十人が尾花沢郵便局に「恒例の年賀状が1通も届いていない」と苦情を言い始めたことでした。	The issue started on January 1st when dozens of local residents started complaining to the Obanazawa Post Office that they hadn't received their traditional and regular New Year cards.
昨日、郵便局は、少年が429枚の年賀はがきを含む600通以上の郵便物を隠していたことが発覚し、本来の宛先に届いていなかったことを受けて、市民とマスコミに謝罪の声明を発表しました。	Yesterday, the post office released their apology to citizens and the media after discovering that the boy had hidden more than 600 postal documents, including 429 New Year postcards, which weren't delivered to their intended recipients.
記者会見でシリポルン氏は 「私のような受刑者を支援してくれた人たちに感謝します」 と述べたそうです。	"Thanks for those who supported a convict like me," Siriporn was quoted as saying at a press conference.
異を唱える人もいるかもしれないが、私は気にしません。	"Some may not agree but I don't care.
応援してくださる方々がいて幸せです。	I am happy that there are people willing to support me.
彼女は「攻撃が間近に予想されることを示唆する情報はない」と述べた。	She said, "There is no intelligence to suggest that an attack is expected imminently.
「しかし、脅威レベルが「危険」から「深刻」に下がったからといって脅威全体が消えたわけではありません。」	However, the reduction of the threat level to severe does not mean the overall threat has gone away."
当局はその脅威の信憑性に疑念を抱いていますが、メリーランド州輸送局はFBIの要請で閉鎖しました。	While authorities are unsure of the credibility of the threat, the Maryland Transportaion Authority made the closure with the urging of the FBI.
ダンプトラックがトンネルの入口を封鎖するのに使われ、80人の警察官が運転者たちに迂回路に向かうように誘導していた。	Dump trucks were used to block tube entrances and assistance of 80 police were on hand to direct motorists to detours.
市内の別ルートである環状道路では、交通の大幅な遅延は報告されていません。	There were no heavy traffic delays reported on the beltway, the city's alternate route.
この事件は、告発を扇動した大手インターネットサービスプロバイダーAOLの本拠地であるバージニア州で起訴されました。	The case was prosecuted in Virginia because it is the home to the leading internet service provider AOL, the company who instigated the charges.
2003年に制定されたこの法律を利用して、ユーザーのメールボックスに迷惑メール (スパムとも呼ばれる) を送り込む行為を有罪とする判決が下されたのは、今回が初めてでした。	This is the first time a conviction has been gained using the legislation enacted in 2003 to curb bulk e-mail, aka spam, from unsolicited distribution into users mailboxes.
英国王立動物虐待防止協会（RSPCA）は、オーストラリアの食肉処理場すべてに監視カメラ（CCTV）の設置を義務付けるように再度要求しています。	Animal Liberation and the Royal Society for the Prevention of Cruelty to Animals (RSPCA) are again calling for the mandatory installation of CCTV cameras in all Australian abattoirs.
RSPCAニューサウスウェールズ州のデビッド・オシャネシー主任検査官は、オーストラリアでは屠殺場の監視と検査を実施して当然だとABCに語りました。	RSPCA New South Wales chief inspector David O'Shannessy told the ABC that surveillance and inspections of abattoirs should be commonplace in Australia.
「監視カメラは動物を扱う業者に、動物福祉が最優先であることを確かに強く伝えてくれるでしょう。」	"The CCTV would certainly send a strong signal to those people working with animals that their welfare is of the highest priority."
カーノ氏は有名だが物議を醸している英語の家庭教師で、Modern EducationやKing's Gloryで講師を務め、最盛期には9,000人の生徒がいたと公言しています。	Karno is a well-known but controversial English tutor who taught under Modern Education and King's Glory who claimed to have 9,000 students at the peak of his career.
彼の手記には、一部の親たちが下品と見なしそううな言葉が使われており、授業中には冒涜的な言葉を吐いていたと言われます。	In his notes he used words which some parents considered coarse, and he reportedly used profanity in class.
Modern Educationは、彼が無許可でバスに大々的な広告を印刷したことや、英語教師の主任を務めていると嘘をついたことを非難しました。	Modern Education accused him of printing large advertisements on buses without authorisation and lying by saying that he was the chief English tutor.
彼は以前にも著作権侵害で告発されたことがありますが、起訴されませんでした。	He has also been accused previously of copyright infringement, but was not charged.
元生徒は「授業中に俗語を使ったり、ノートにデート術を書いて教えたり、生徒同士のような感じだった」と話しています。	A former student said that he 'used slang in class, taught dating skills in notes, and was just like the students' friend.'
歴史家たちは、過去のFBIの方針が、解決しやすい事件、特に盗難車事件にリソースを集中させ、FBIの成功率を上げることを目的としていると批判しています。	Historians have criticized past FBI policies for focusing resources on cases which are easy to solve, especially stolen car cases, with the intent of boosting the agency's success rate.
連邦議会は2005年度から猥褻物取締法への資金提供を開始し、FBIはアダルトポルノに10人の捜査員を投入しなければならないと規定しました。	Congress began funding the obscenity initiative in fiscal 2005 and specified that the FBI must devote 10 agents to adult pornography.
ペンシルベニア州ピッツバーグの小児病院で働いていた医師は、水曜日に母親が車のトランクで死んでいるのが発見された後、加重殺人で起訴される予定であるとオハイオ州の当局は述べています。	A doctor who worked at Children's Hospital of Pittsburgh, Pennsylvania will be charged with aggravated murder after her mother was found dead in the trunk of her car Wednesday, authorities in Ohio say.
マラー・バラスブラマニアン博士（29歳）は、シンシナティの郊外、北約15マイルのオハイオ州ブルーアッシュで遺体となって発見され、道路脇の地面にＴシャツと下着姿で横たわる姿は明らかに薬漬けの状態でした。	Dr. Malar Balasubramanian, 29, was found in Blue Ash, Ohio, a suburb approximately 15 miles north of Cincinnati lying on the ground beside the road in a T-shirt and underwear in an apparently heavily medicated state.
彼女は500フィート離れたところに駐車してあった黒いオールズモビル・イントリーグまで警官を案内した。	She directed officers to her black Oldsmobile Intrigue which was 500 feet away.
そこにあったのは、血まみれの毛布に覆われたサロジャ・バラスブラマニアンさん（53歳）の遺体でした。	There, they found the body of Saroja Balasubramanian, 53, covered with blood-stained blankets.
警察によると、その遺体は1日ほど前からそこにあったという。	Police said that the body appeared to have been there for about a day.
負傷者が病院に搬送された後に戦闘が収まると、他の約40人の受刑者は中庭に残り、独房に戻ることを拒否しました。	When the fighting ceased after the wounded were transported to the hospital, about 40 of the other remaining inmates stayed in the yard and refused to return to their cells.
交渉人たちは事態の収拾を図ろうとしたが、囚人の要求は明らかではない。	Negotiators tried to rectify the situation, but the prisoners' demands are not clear.
10:00～11:00pm MDTの間に受刑者が庭に火を放ったのでした。	Between 10:00-11:00 pm MDT, a fire was started by the inmates in the yard.
まもなく暴動鎮圧用の装備を着用した警官たちが収容所に入り、催涙ガスで受刑者を追い詰めました。	Soon, officers equipped with riot gear entered the yard and cornered the inmates with tear gas.
消防隊は最終的に午後11時35分までに火を消しました。	Fire rescue crews eventually doused the fire by 11:35 pm.
ビシュケクの街路には法執行官がいなかったため、一晩中略奪が続いたと伝えられています。	Widespread looting reportedly continued overnight, as law enforcement officers were not present on Bishkek's streets.
ある観察者がビシュケクを「無政府状態」に陥っていると表現したように、ギャングたちが街路を徘徊し、日用品店を略奪しました。	Bishkek was described as sinking into a state of "anarchy" by one observer, as gangs of people roamed the streets and plundered stores of consumer goods.
ビシュケクの住民の一部は、南部から来た抗議者たちを無法であると非難しました。	Several Bishkek residents blamed protesters from the south for the lawlessness.
先日、中国の新華社通信は飛行機がハイジャックされたと報じました。	Earlier the Chinese news agency Xinhua reported a plane to be hijacked.
その後の報告によると、飛行機は爆破予告を受け、アフガニスタンに戻り、カンダハールに着陸したとのことでした。	Later reports then stated the plane received a bomb threat and was diverted back to Afghanistan, landing in Kandahar.
初期の報告では、この飛行機はウルムチへの緊急着陸を拒否された後、行く先を変更してアフガニスタンに向かったとされています。	The early reports say the plane was diverted back to Afghanistan after being denied an emergency landing in Ürümqi.
知事執務式の外で爆弾が爆発しました。	One bomb exploded outside the governor general's office.
その後2時間のうちに、さらに3つの爆弾が官庁施設の付近で爆発しました。	Three more bombs exploded near government buildings in a period of two hours.
一部の報告では公式の死者数は8人とされ、公式の報告では最大30人が負傷したことが確認されていますが、最終的な人数はまだわかっていません。	Some reports put the official death toll at eight, and official reports confirm that up to 30 were injured; but final numbers are not yet known.
汚染されたペットフードを食べて死亡したペットの尿サンプルからシアン酸とメラミンの両方が検出されました。	Both cyanuric acid and melamine were found in urine samples from pets that died after consuming contaminated pet food.
その大学の研究者たちによれば、この2つの化合物は、互いに反応して腎臓の機能を阻害しうる結晶を形成します。	The two compounds react with one another to form crystals that may block kidney function, researchers at the university said.
研究者らは、メラミンとシアヌル酸の添加によって猫の尿に形成された結晶を観察しました。	The researchers observed crystals formed in cat urine by the addition of melamine and cyanuric acid.
これらの結晶の組成は、赤外分光法（FTIR）で比較すると、患部のペットの尿中に見られるものと一致します。	The composition of these crystals matches those found in the urine of affected pets when compared by infrared spectroscopy (FTIR).
死亡したのは、ニコラス・オールデンさん（25歳）と運転手を務めるザカリー・カッドバックさん（21歳）でした。	The fatalities were Nicholas Alden, 25, and Zachary Cuddeback, 21. Cuddeback had been the driver.
エドガー・ベギラさんは腕と顎を負傷し、クリストファー・シュナイダーさんは顔の再建手術が必要なほどの重症を負いました。	Edgar Veguilla received arm and jaw wounds while Kristoffer Schneider was left requiring reconstructive surgery for his face.
ウカの武器は5人目の男の頭に向けられて失敗した。シュナイダーには痛みがあり、片目は失明し、頭蓋骨の一部が欠損し、顔はチタンで再建されている。	Uka's weapon failed whilst pointed at a fifth man's head. Schneider has ongoing pain, blindness in one eye, a missing section of skull and a face rebuilt from titanium.
シュナイダーは母国の米空軍基地からビデオリンクで証言しました。	Schneider testified via videolink from a USAF base in his homeland.
マディヤ・プラデシュ州警察は、盗まれたノートパソコンと携帯電話を回収しました。	The Madhya Pradesh Police recovered the stolen laptop and mobile phone.
警察副監察官のD・K・アーヤ氏は、「スイス人女性を強姦した5人を逮捕し、彼女の携帯電話とノートパソコンを回収した」と述べました。	Deputy Inspector General D K Arya said, "We have arrested five persons who raped the Swiss woman and recovered her mobile and laptop".
被告人たちの氏名は、ババ・カンジャール、ブータ・カンジャール、ランプロ・カンジャール、ガザ・カンジャール、ヴィシュヌ・カンジャールです。	The accused are named as Baba Kanjar, Bhutha Kanjar, Rampro Kanjar, Gaza Kanjar and Vishnu Kanjar.
警察のチャンドラ・シェカール・ソランキ総監によれば、被告人は顔を隠して法廷に出頭したそうです。	Police superintendent Chandra Shekhar Solanki said the accused appeared in court with covered faces.
アデコヤ氏はその後、息子の殺害容疑でエディンバラ保安官裁判所に出頭しています。	Adekoya has since been in Edinburgh Sheriff Court charged with murdering her son.
彼女は起訴と公判まで身柄を勾留されていますが、本人の写真が広く公開されているため、目撃者の証拠が損なわれる可能性があります。	She is in custody pending indictment and trial, but any eyewitness evidence may be tainted because her image has been widely published.
これは英国内の他の地域で一般的に行われていることですが、スコットランドの司法制度は異なっており、裁判所は写真の公開を潜在的に悪影響のあるものと見なしています。	This is common practice elsewhere in the UK but Scottish justice works differently and courts have viewed publication of photos as potentially prejudicial.
ダンディー大学のパメラ・ファーガソン教授は、「容疑者の写真などを公開する報道記者は危い橋を渡っている」と指摘しています。	Professor Pamela Ferguson of the University of Dundee notes "journalists do seem to be walking a dangerous line if publishing photos etc of suspects."
起訴を全面的に担当する王座裁判所刑事部は、記者団に対して、少なくとも起訴されるまではこれ以上のコメントはしないとの意向を示しています。	Crown Office, which is in overall charge of prosecutions, has indicated to journalists that no further comment will be made at least until indictment.
フィリピンの首都マニラでフィリピン人の元警官がバスをハイジャックして香港の観光客を人質にしています。	A former Filipino policeman has kept Hong Kong tourists hostage by hijacking their bus in Manila, the capital of the Philippines.
ロランド・メンドーサはM16ライフルで観光客に発砲しました。	Rolando Mendoza fired his M16 rifle at the tourists.
何人もの人質が救出されましたが、これまでに少なくとも6人の死亡が確認されています。	Several hostages have been rescued and least six have been confirmed dead so far.
子供と高齢者を含めた人質6名が早期に解放され、フィリピン人の写真家たちも同じく解放されました。	Six hostages, including the children and elderly, were released early, as were the Filipino photographers.
写真家たちはご不浄に行きたがった高齢の女性の身代わりとなった。メンドーサ容疑者は銃殺された。	The photographers later took the place of an aged lady as she needed the lavatory. Mendoza was gunned down.
