赤潮は、天然の単細胞海洋生物であるカレニア・ブレビスの濃度が通常よりも高くなることで発生します。	Red tide is caused by a higher than normal concentration of Karenia brevis, a naturally-occurring single-celled marine organism.
自然要因が交錯して理想的な条件を作り出し、この藻類が劇的に増殖する可能性があります。	Natural factors can intersect to produce ideal conditions, allowing this algae to increase in number dramatically.
この藻は、人間と魚類の両方の神経に有害な神経毒を産生します。	The algae produces a neurotoxin that can disable nerves in both humans and fish.
魚の主な死因の1つは水中に高濃度の毒素です。	Fish often die because of the high concentrations of the toxin in the waters.
人間は、風や波の力で空気中に取り込まれた水分を呼吸時に吸い込んだ場合にその影響を受けることがあります。	Humans can be affected by breathing affected water taken into the air by wind and waves.
熱帯性サイクロン「ゴヌ」は、モルディブの言葉でヤシの葉でできた袋から名付けられ、吹き続ける風がピーク時には時速240 km（時速149マイル）に達しました。	At its peak, Tropical Cyclone Gonu, named for a bag of palm leaves in the language of the Maldives, reached sustained winds of 240 kilometers an hour (149 miles per hour) .
本日早朝までに風は83km/h前後となり、今後も弱まり続けると予想されていました。	By early today, winds were around 83 km/h, and it was expect to keep weakening.
ルノ号は120～160立米の燃料を積んでいましたが、強風と高波によって船体が防波堤に押し込まれてしまいました。	The Luno had 120–160 cubic metres of fuel aboard when it broke down and high winds and waves pushed it into the breakwater.
乗組員12人がヘリコプターに救助され、唯一の負傷は鼻骨骨折でした。	Helicopters rescued the twelve crewmembers and the only injury was a broken nose.
全長100メートルの船は、いつもどおりに肥料の貨物を積み込む途中だったため、当初、関係者は船から荷物が落下するのではないかと心配していました。	The 100-metre ship was en route to pick up its usual fertiliser cargo and initially officials feared the vessel could spill a load.
「我々は、2020年までにGDPあたりの二酸化炭素排出量を2005年の水準から大幅に削減するように努力する」と胡錦濤国家主席は述べました。	"We will endeavour to cut carbon dioxide emissions per unit of GDP by a notable margin by 2020 from the 2005 level," Hu said.
胡氏は、削減する数値を定めませんでしたが、削減は中国の経済産出量に基づいて実施されるだろうと述べました。	He did not set a figure for the cuts, saying they will be made based on China's economic output.
胡錦濤国家主席は、発展途上国に「まず汚染してから後始末をするというこれまでのやり方を避けるように」と呼びかけました。	Hu encouraged developing countries "to avoid the old path of polluting first and cleaning up later."
「しかし、発展段階、責任、能力を超えた義務を負うことを求められてはならない」と付け加えました。	He added that "they should not, however, be asked to take on obligations that go beyond their development stage, responsibility and capabilities."
月曜日の午後10時8分にモンタナ州西部で中規模の地震が発生しました。	A moderate earthquake shook western Montana at 10:08 p.m. on Monday.
米国地質調査所(USGS)とその国家地震情報センターに被害の緊急報告は入っていません。	No immediate reports of damage have been received by the United States Geological Survey (USGS) and its National Earthquake Information Center.
震源地は、ディロンの北北東約20 km（15マイル）、ビュートの南約65 km（40マイル）の地点でした。	The earthquake was centered about 20 km (15 miles) north-northeast of Dillon, and about 65 km (40 miles) south of Butte.
展示された5分後に風が吹き始め、1分後には時速70キロに達しました... その後、雨が降り、雨粒は肌に当たると針のように痛い大粒で、やがて空から雹が降ってきて、人々はパニックになり、悲鳴を上げながら、われ先にと走り回っていました。	Five minutes into the display a wind starts rolling in, about a minute later, the wind is reaching 70km/h... then the rain comes, but so hard and so large that it slaps your skin like a needle, then hail fell from the sky, people panicking and screaming and running over each other.
「私は妹やその友人とはぐれてしまったのですが、途中で車椅子に乗った障害者が2人いて、飛び越えて車椅子を押している人たちがいました」とアルマン・ヴェルサーチさんは語っています。	I lost my sister and her friend, and on my way there were two disabled people in wheelchairs, people just jumping over and pushing them," Armand Versace said.
また、NHKは新潟県の柏崎刈羽原発が正常に稼働していると報道していました。	NHK also reported that the Kashiwazaki Kariwa nuclear power plant in Niigata prefecture was operating normally.
北陸電力は、地震による影響はなく、志賀原発の1号機と2号機を停止したと報告しました。	Hokuriku Electric Power Co. reported no effects from the earthquake and that the Number 1 and 2 reactors at its Shika nuclear power plant were shut down.
当該地域の約9400軒の家庭に水道がなく、約100軒の家庭には電気がないことが報告されています。	It is reported that some 9400 homes in the region are without water and approximately 100 without electricity.
被災地では一部の道路の被害を受け、鉄道が寸断され、石川県の能登空港も閉鎖されたままです。	Some roads have been damaged, railway service interrupted in the affected areas, and the Noto Airport in Ishikawa prefecture remains closed.
