ヨーロッパ側のトルコ（バルカン半島の東トラキアまたはルメリア）は国土の3%を占めています。	European Turkey (eastern Thrace or Rumelia in the Balkan peninsula) includes 3% of the country.
トルコの領土は、長さ1,600 km以上、幅800 km以上でのほぼ長方形です。	The territory of Turkey is more than 1,600 kilometres (1,000 mi) long and 800 km (500 mi) wide, with a roughly rectangular shape.
湖を含めたトルコの面積は783,562 km2（300,948平方マイル）で、そのうち南西アジアが755,688 km2（291,773平方マイル）、ヨーロッパが23,764 km2（9,174平方マイル）です。	Turkey's area, including lakes, occupies 783,562 square kilometres (300,948 sq mi), of which 755,688 square kilometres (291,773 sq mi) are in south west Asia and 23,764 square kilometres (9,174 sq mi) in Europe.
トルコの面積は世界で37番目に大きく、フランス本土とイギリスを合わせた大きさとほぼ同じです。	Turkey's area makes it the world's 37th-largest country, and is about the size of Metropolitan France and the United Kingdom combined.
トルコは三方を海に囲まれた国で、西はエーゲ海、北は黒海、南は地中海にそれぞれ面しています。	Turkey is encircled by seas on three sides: the Aegean Sea to the west, the Black Sea to the north and the Mediterranean Sea to the south.
ルクセンブルクは歴史の長い国ですが独立は1839年に遡ります。	Luxembourg has a long history but its independence dates from 1839.
現在のベルギー領の一部は過去にルクセンブルク領でしたが、1830年代のベルギー革命後にベルギー領になりました。	Present-day parts of Belgium were part of Luxembourg in the past but became Belgian after the 1830s Belgian Revolution.
ルクセンブルクは、常に中立国としての立場を守ろうと努めていましたが、 第一次世界大戦でも第二次世界大戦でもドイツに占領されました。	Luxembourg has always tried to remain a neutral country but it was occupied in both World War I and World War II by Germany.
1957年にルクセンブルクは現在の欧州連合（EU）の創設メンバーとなりました。	In 1957 Luxembourg became a founding member of the organization which is today known as the European Union.
ドゥルギャルゾンは、（フォンディ村の）パロ地区の高台にある廃墟となった要塞や仏教寺院です。	The Drukgyal Dzong is a ruined fortress and Buddhist monastery in the upper part of the Paro District (in Phondey Village).
1649年にシャブドゥン・ガワン・ナムゲルがチベット・モンゴル軍との戦いに勝利したことを記念して、この要塞を建設したと言われています。	It is said that in 1649, Zhabdrung Ngawang Namgyel created the fortress to commemorate his victory against the Tibetan-Mongol forces.
1951年の火災によりほとんどが焼失し、ジャブドゥルング・ガワン・ナムゲルの絵など、ドゥルギャルゾン遺跡の一部しか残りませんでした。	In 1951, a fire caused for only some of the relics of the Drukgyal Dzong to remain, such as the image of Zhabdrung Ngawang Namgyal.
火災後の要塞は保存・保護され、今ではブータンで話題の観光名所の1つとして残っています。	After the fire, the fortress was preserved and protected, remaining to be one of Bhutan's most sensational attractions.
18世紀のカンボジアは、タイとベトナムという2つの強力な隣国に挟まれて苦しい立場にありました。	During the 18th century Cambodia found itself squeezed between two powerful neighbors, Thailand and Vietnam.
タイ人は18世紀に幾度もカンボジアに侵入し、1772年にはプノンフェンを破壊しました。	The Thais invaded Cambodia several times in the 18th century and in 1772 they destroyed Phnom Phen.
18世紀末にはベトナム人もカンボジアを侵略しました。	In the last years of the 18th century the Vietnamese also invaded Cambodia.
ベネズエラ人の18%が失業者であり、就業者のほとんどは非公式経済で働いています。	Eighteen percent of Venezuelans are unemployed, and most of those who are employed work in the informal economy.
ベネズエラで働く人の3分の2がサービス業、4分の1近くが工業、5分の1が農業に従事しています。	Two thirds of Venezuelans who work do so in the service sector, nearly a quarter work in industry and a fifth work in agriculture.
ベネズエラ人にとって石油は重要な産業であり、石油産業に従事する人はわずか1%に過ぎないにもかかわらず、同国は純輸出国です。	An important industry for Venezuelans is oil, where the country is a net exporter, even though only one percent work in the oil industry.
サッカーのイタリア代表は、ドイツ代表と並んで世界で2番目に成績の良いチームで、2006年にはFIFAワールドカップで優勝しています。	Italy's national football, along with German national football team is the second most successful team in the world and were the FIFA World Cup champions in 2006.
人気のスポーツは、サッカー、バスケットボール、バレーボール、水球、フェンシング、ラグビー、サイクリング、アイスホッケー、ローラーホッケー、F1モーターレースなどです。	Popular sports include football, basketball, volleyball, water-polo, fencing, rugby, cycling, ice hockey, roller hockey and F1 motor racing.
北部地域ではウィンタースポーツが盛んで、国際試合やオリンピックに出場するイタリア人選手を輩出しています。	Winter sports are most popular in the Northern regions, with Italians competing in international games and Olympic events.
日本には約7,000の島々があり、その最大は本州列島で、世界で7番目に大きい島とされています。	Japans holds nearly 7,000 islands (the biggest being Honshu), making Japan the 7th largest island in the world!
日本は島々の集まりなので、地理的によく「群島」と呼ばれます。	Due to the cluster/group of islands Japan has, Japan is often referred to, on a geographical stance, as an "archipelago"
台湾の始まりは15世紀にヨーロッパの船乗りたちがこの島の名前を「イルハ・フォルモサ」（美しい島）と呼んだことから始まりました。	Taiwan beginning start way back in 15th century where European sailors passing by record the island’s name as Ilha Formosa, or beautiful island.
1624年、オランダの東インド会社が台湾南西部に拠点を置き、原住民の穀物生産方法を変革し、中国人労働者を雇って米や砂糖のプランテーションに従事させました。	In 1624,Dutch East India Company establishes a base in southwestern Taiwan, initiating a transformation in aboriginal grain production practices and employing Chinese laborers to work on its rice and sugar plantations.
1683年に清朝（1644～1912年）軍が台湾西部および北部の沿岸部を占領し、1885年に台湾を清国の省とすることを宣言しました。	In 1683, Qing dynasty (1644-1912) forces take control of Taiwan’s western and northern coastal areas and declared Taiwan as a province of the Qing Empire in 1885.
1895年、第一次日清戦争（1894年～1895年）の敗戦後、清国政府は下関条約に調印し、台湾の主権を日本に譲りました。	In 1895, after defeat in the First Sino-Japanese War (1894-1895), the Qing government signs the Treaty of Shimonoseki, by which it cedes sovereignty over Taiwan to Japan, which rules the island until 1945.
