現代のアイススケート靴の刃（ブレード）は、2枚のエッジとその間に凹形の空洞から成り、2枚のエッジは刃が傾いた状態でも氷をより的確に捉えます。	The blade on a modern ice skate has a double edge with a concave hollow between them. The two edges allow for a better grasp of the ice, even when tilted.
ブレードの底部がわずかに湾曲しているため、ブレードが片側かもう片側に傾くと、氷と接触しているエッジも湾曲します。	Because the bottom of the blade is slightly curved, as the blade tilts to one side or the other, the edge which is in contact with the ice also curves.
これを利用してスケート選手はターンします。スケート選手はスケートが右に傾けば右を向き、左に傾けば左を向きます。	This causes the skater to turn. If the skates tilt to the right, the skater turns right, if the skates tilt to the left, the skater turns left.
かつてのエネルギー準位に復帰するためには、光から得た余分なエネルギーを除去しなければなりません。	To return to their previous energy level, they must get rid of the extra energy they got from the light.
「光子」と呼ばれる光の小粒子の放出によるものです。	They do this by emitting a tiny particle of light called a "photon".
科学者たちはこのプロセスを「放射線の刺激放出」と呼びますが、これは明るい光によって原子が刺激を受けて光の粒子を放出するためであり、光は放射線の一種です。	Scientists call this process "stimulated emission of radiation" because the atoms are stimulated by the bright light, causing the emission of a photon of light, and light is a type of radiation.
次の写真は、原子が光子を放出している様子です。もちろん、実際には写真よりもはるかに微小です。	The next picture shows the atoms emitting photons. Of course, in reality photons are a lot smaller than those in the picture.
光子は原子を構成する物質よりもさらに微小な粒子です！	Photons are even smaller than the stuff that makes up atoms!
何百時間か使用を続けると、最終的に電球内のフィラメントが燃え尽きて電球は点灯しなくなります。	After hundreds of hours of operation the filament in the bulb eventually burns out and the light bulb no longer works.
そこで必要になるのが電球の交換です。電球を交換する際には注意が必要です。	The light bulb then needs replacing. It is necessary to be careful in replacing the light bulb.
まず、照明器具のスイッチを切るか、ケーブルを外す必要があります。	First, the switch for the light fixture needs to be turned off or the cable disconnected.
これは、電球の一部がソケット内にあるときに、ソケットや電球の金属部に触れると、電球の金属部が接しているソケットに流れる電流によって激しい感電を起こすことがあるためです。	This is because electricity flowing into the socket where the metallic part of bulb sits can give you a severe electric shock if you touch the inside of the socket or the metal base of the bulb while it is still partly in the socket.
時間とは、身近にあって私たちのあらゆる活動に影響を与えるものでありながら、理解しにくい概念です。	Time is something that is all around us, and affects everything we do, yet is difficult to understand.
時間については何千年も前から宗教家、哲学者、科学者が研究を重ねてきました。	Time has been studied by religious, philosophical, and scientific scholars for thousands of years.
私たちは、時間を未来から現在を経て過去に至るまでの一連の出来事として経験します。	We experience time as a series of events passing from the future through the present to the past.
時間は、出来事の継続時間（長さ）を比べる方法でもあります。	Time is also how we compare the duration (length) of events.
周期的な出来事の繰り返しを観察することで、時間の経過を自分で目印にすることができます。周期的な出来事とは、何度も定期的に発生することです。	You can mark the passing of time yourself by observing the repetition of a cyclical event. A cyclical event is something that happens again and again regularly.
今日、コンピュータは写真や動画の操作に使用されています。	Computers today are used to manipulate pictures and videos.
コンピューターで高度なアニメーションを制作でき、そういったアニメーションがテレビや映画で放映されることが増えています。	Sophisticated animations can be constructed on computers, and this kind of animation is increasingly being used in television and films.
多くの場合、音楽は高性能コンピュータで記録され、サウンドの処理やミキシングがされます。	Music is often recorded using sophisticated computers to process and mix sounds together.
ハラッパーやモヘンジョダロの都市では、下水道が整備され、ほとんどすべての住居に水洗トイレがありました。	The cities of Harappa and Mohenjo-daro had a flush toilet in almost every house, attached to a sophisticated sewage system.
ギリシャのクレタ島やサントリーニ島のミノアの都市の家々では、下水道の遺構が発見されています。	Remains of sewage systems have been found in the houses of the Minoan cities of Crete and Santorini in Greece.
古代のエジプト、ペルシャ、中国にもトイレはありました。ローマ文明の時代には混浴公衆浴場設備の一部として設けられていた例もあります。	There were also toilets in ancient Egypt, Persia and China. In Roman civilization, toilets were sometimes part of public bath houses where men and women were together in mixed company.
何千マイルも離れた場所にいる相手に電話をかけると自動的に衛星を経由した通話になります。	When you call someone who is thousands of miles away, you are using a satellite.
宇宙にある人工衛星は通話を受信して、ほぼ瞬時にそれを反映します。	The satellite in space gets the call and then reflects it back down, almost instantly.
衛星はロケットで宇宙に送られました。科学者が宇宙で望遠鏡を使う理由は、地球の大気によって人間の視界に入る光や景色の一部が歪むからです。	The satellite was sent into space by a rocket. Scientists use telescopes in space because the Earth’s atmosphere distorts some of our light and view.
衛星や望遠鏡を打ち上げて宇宙空間に配備するためには、まず高さ100フィート以上の巨大ロケットが必要です。	It takes a giant rocket over a 100 feet high to put a satellite or telescope in space.
この車輪は信じられないほど世界を変えました。この車輪が私たちにもたらした最大の功績は、交通機関をはるかに乗り心地良く、かつ高速にしたことです。	The wheel has changed the world in incredible ways. The biggest thing that the wheel has done for us is given us much easier and faster transportation.
列車、車、その他の多くの交通手段がそこから生まれました。	It has brought us the train, the car, and many other transportation devices.
上げ弓のマークはV字のように見え、下げ弓のマークはホチキスの針または四角形の底辺が欠けたような形です。	The "up bow" mark looks like a V and the "down bow mark" like a staple or a square missing its bottom side.
アップとは先端から始めて弓を押すことであり、ダウンはフロッグ（手で弓を保持している場所）から始めて弓を引くことです。	Up means you should start at the tip and push the bow, and down means you should start at the frog (which is where your hand is holding the bow) and pull the bow.
上げ弓は通常やわらかい音を、下げ弓はより強く、主張のある音を生み出します。	An up-bow usually generates a softer sound, while a down-bow is stronger and more assertive.
鉛筆で自由に符号を書き込めますが、印字された弓形の符合には音楽的な理由があることを覚えておきましょう。通常、その符号に従うべきです。	Feel free to pencil in your own marks, but remember the printed bowing marks are there for a musical reason, so they should usually be respected.
このように、世に出てきた当時の鉛筆は多くの人にとって良き友人でした。	Thus, the pencil was a good friend to many people when it came out.
残念なことに、新たな書法の登場とともに鉛筆の地位や用途は低下していきました。	Sadly, as newer methods of writing have emerged, the pencil has been relegated to lesser status and uses.
今ではパソコンの画面にメッセージを入力する人が増え、鉛筆削りは必要なくなりました。	People now write messages on computer screens, never having to come close to a sharpener.
さらに新しいものが登場したら、キーボードはどうなるのだろうかと思ってしまいます。	One can only wonder what the keyboard will become when something newer comes along.
核爆弾は、1つの原子核に多くの陽子と中性子を集めるにはエネルギーが必要であるという原理で作用します。	The fission bomb works on the principle that it takes energy to put together a nucleus with many protons and neutrons.
重い荷車を転がして丘を登っていくようなものです。原子核を再び分裂させると、そのエネルギーの一部が放出されます。	Sort of like rolling a heavy cart up a hill. Splitting the nucleus up again then releases some of that energy.
原子の中には不安定な原子核を持つものがあり、その原子核は、ほとんど何もしなくても分裂してしまう傾向があります。	Some atoms have unstable nuclei which means that they tend to break apart with little or no nudging.
