高温条件の日中に、旅行者は、水（やその他の景色）の幻覚を生み出す蜃気楼を体験することがあります。	In the heat of the day, travelers can experience mirages that give the illusion of water (or other things).
旅行者が蜃気楼を追いかけて貴重な体力や残りの水を浪費した場合、これらが危険につながる可能性があります。	These can be dangerous if the traveler pursue the mirage, wasting precious energy and remaining water.
どんなに暑い砂漠でも、夜間に極寒になることがあります。暖かい服を着ないと低体温症になる恐れがあります。	Even the hottest of deserts can become extremely cold at night. Hypothermia is a real risk without warm clothing.
特に夏場に熱帯雨林の中をハイキングしようと思ったら、蚊に注意する必要があります。	In summer, especially, you'll need to watch out for mosquitoes if you decide to hike through the rainforest.
亜熱帯雨林を車で走行するにしても、乗り降りのためにドアを開けている数秒だけで蚊が車内に入ってくるのに十分な時間です。	Even if you're driving through the subtropical rainforest, a few seconds with the doors open while you get inside the vehicle is enough time for mosquitoes to get in the vehicle with you.
鳥インフル（正式には鳥インフルエンザ）は、鳥類と哺乳類のいずれにも感染する恐れがあります。	Bird flu, or more formally avian influenza, can infect both birds and mammals.
人間について報告された症例は1000件以下ですが、致死的な症例もあります。	Fewer than a thousand cases have ever been reported in humans, but some of them have been fatal.
主に家禽を扱う商売の人々は感染の危険が高いですが、バードウォッチャーにも多少の危険があります。	Most have involved people who work with poultry, but there is also some risk to birdwatchers.
ノルウェーで典型的なのは、急峻なフィヨルドと渓谷が突然ほぼ平坦な高原に変わる地形です。	Typical for Norway are steep fjords and valleys that suddenly give way to a high, more or less even plateau.
これらの台地はよく「ヴィッデ」と呼ばれますが、これは木々がなく開けた広い空間、無限の広がりを意味しています。	These plateaus are often referred to as "vidde" meaning a wide, open treeless space, a boundless expanse.
ローガランドやアグデルでは、通常は「ヘイ」と呼ばれ、ヒースで覆われることの多い森林のない湿地帯を意味しています。	In Rogaland and Agder they are usually called "hei" meaning a treeless moorland often covered in heather.
氷河は安定した状態ではなく、山を流れ落ちていきます。そのため、ひび割れやクレバスが発生し、雪の橋で見えなくなることがあります。	The glaciers are not stable, but flow down the mountain. This will cause cracks, crevasses, which may be obscured by snow bridges.
氷の洞窟の壁面や屋根が崩れ落ち、隙間が閉じてしまうこともあります。	The walls and roofs of ice caves can collapse and cracks can get closed.
氷河の端では、巨大な塊が崩れ落ちてきて、端から遠くに飛び出したり、転がったりすることがあります。	At the edge of glaciers huge blocks break loose, fall down and perhaps jump or roll farther from the edge.
避暑地の観光シーズンは、一般的にインドの夏季にピークを迎えます。	The tourist season for the hill stations generally peaks during the Indian summer.
しかし、多くのヒルステーションには十分な積雪があり、スキーやスノーボードなどのアクティビティを楽しめるので、冬にはまた違った美しさと魅力があります。	However, they have a different kind of beauty and charm during winter, with many hill stations receiving healthy amounts of snow and offering activities such as skiing and snowboarding.
近世以前の天文台は、今日ではほとんどが時代遅れで廃止され、博物館や教育の場として残っています。	Pre-modern observatories are usually obsolete today, and remain as museums, or sites of education.
最も被害が大きかった頃の公害は現在とは問題の種類が異なり、都市部や学校の校庭で発生していたため、現代の問題よりも身近なものでした。	As light pollution in their heyday was not the kind of problem it is today, they are usually located in cities or at campuses, easier to reach than those built in modern times.
最新式の研究用望遠鏡の多くは、良好な大気条件下で観測できるように遠隔地の巨大な施設に設置されています。	Most modern research telescopes are enormous facilities in remote areas with favorable atmospheric conditions.
お花見と呼ばれる桜の花の鑑賞は、8世紀から日本の文化の一部となっています。	Cherry blossom viewing, known as hanami, has been a part of Japanese culture since the 8th century.
そのコンセプトは、梅の花を好む中国から来ています。	The concept came from China where plum blossoms were the flower of choice.
日本で最初に開かれた花見は、天皇が自らと朝廷周辺に住まう貴族のためだけに主催したものでした。	In Japan, the first cherry blossom parties were hosted by the emperor only for himself and other members of the aristocracy around the Imperial Court.
植物は自然環境にあるときに最も見栄えがするのですから、「1本だけ」ならと標本に持ち帰りたい誘惑に負けないでください。	Plants look their best when in a natural environment, so resist the temptation to remove even "just one" specimen.
手入れの行き届いた庭園を訪れた場合に「標本」を集めようとしたら言い訳の余地なく追い出されます。	If visiting a formally arranged garden, collecting "specimens" is also going to get you ejected, without discussion.
シンガポールは一般的に極めて治安が良く、非常に移動しやすく、到着後にはほとんど何でも購入できます。	Singapore is generally an extremely safe place to be and very easy to navigate, and you can buy almost anything after arriving.
しかし、赤道から数度北の「高緯度の熱帯」に位置しているため、（常に）暑さと（まれにですが快晴時に）強い日差しの両方に対処する必要があります。	But being placed in the "high tropics" just a few degrees north of equator you will need to deal with both heat (always) and strong sun (when the sky is clear, more rarely).
また、聖書の家長アブラハム、イサク、ヤコブ、そして彼らの妻たちが埋められているという伝説の埋葬地であるヘブロン方面に北上するバスも何本かあります。	There are also a few buses going north to Hebron, the traditional burial place of the Biblical patriarchs Abraham, Isaac, Jacob, and their wives.
乗ろうとしているバスが、キルヤト・アルバ近くのユダヤ人集落方面に向かうだけでなく、ヘブロン行きであることを確認してください。	Check that the bus you are thinking of taking goes into Hebron and not just to the nearby Jewish settlement of Kiryat Arba.
内陸の水路に沿った散策は休日を過ごすうえで面白いテーマになるでしょう。	Inland waterways can be a good theme to base a holiday around.
例えば、ロワール渓谷、ライン渓谷の城を訪れたり、趣ある街並みへ向かうドナウ川のクルーズ船に乗ったり、エリー運河でボートに乗るのもいいでしょう。	For example visiting castles in the Loire Valley, the Rhine valley or taking a cruise to interesting cites on the Danube or boating along the Erie Canal.
人気のあるハイキングやサイクリングのコースのルートも定めています。	They also define routes for popular hiking and cycling trails.
初期にガラパゴス諸島にやってきた動物はいずれも、泳ぐか、飛ぶか、浮いてやってきました。	All animals that originally arrived in the islands came here either by swimming, flying or floating.
大陸から離れているため、哺乳類は旅をすることができず、ゾウガメはガラパゴスの主要な草食動物になりました。	Due to the long distance from the continent mammals were unable to make the journey making the giant tortoise the primary grazing animal in the Galapagos.
ガラパゴスに人が足を踏み入れて以来、ヤギ、馬、牛、ネズミ、猫、犬など多くの哺乳類が連れて来られました。	Since the arrival of man to the Galapagos, many mammals have been introduced including goats, horses, cows, rats, cats and dogs.
冬に北極や南極を訪れると、太陽が地平線から昇らない「極夜」を体験することができます。	If you visit the Arctic or Antarctic areas in the winter you will experience the polar night, which means that the sun doesn't rise above the horizon.
この現象によってほぼ24時間空が暗くなるので、オーロラを見るには良い機会となります。	This offers a good opportunity to see the Aurora borealis, as the sky will be dark more or less around the clock.
この地域は人口がまばらで、光害問題もほとんどないので、星空を楽しむことができます。	As the areas are sparsely populated, and light pollution therefore often not a problem, you will also be able to enjoy the stars.
