28歳のビダル選手は、3シーズン前にセビージャから移籍してバルサに所属していました。	28-year-old Vidal had joined Barça three seasons ago, from Sevilla.
カタルーニャの州都に移って以来、ビダルはクラブで49試合に出場しました。	Since moving to the Catalan-capital, Vidal had played 49 games for the club.
ナダルの対カナダ戦の戦績は7-2です。	Nadal's head to head record against the Canadian is 7–2.
最近では、ブリスベン・オープンでラオニッチに敗れています。	He recently lost against Raonic in the Brisbane Open.
試合中にナダルはファーストサーブで76ポイントを奪い、88%のネットポイントを獲得しています。	Nadal bagged 88% net points in the match winning 76 points in the first serve.
試合後にキング・オブ・クレーは、「最も重要なイベントの決勝に戻ってきたことに興奮している。これに勝つためにここに来た」と語りました。	After the match, King of Clay said, "I am just excited about being back in the final rounds of the most important events. I am here to try to win this."
今日のプレイヤー・オブ・ザ・デイは、ワシントン・キャピトルズのアレックス・オヴェーチキン選手です。	Today's Player of the Day is Alex Ovechkin of the Washington Capitals.
ワシントンがアトランタ・トラッシャーズに5-3で勝利した際には2ゴール2アシストを記録しています。	He had 2 goals and 2 assists in Washington's 5-3 win over the Atlanta Thrashers.
この夜、オベーチキンの最初のアシストは、ルーキーのニックラス・バックストロームが決めた決勝ゴールでした。	Ovechkin's first assist of the night was on the game-winning goal by rookie Nicklas Backstrom;
その夜の2つ目のゴールは、彼の今季60点目のゴールとなりました。1シーズンで60点以上を記録した選手は、1995～1996年のジャロミア・ジャグとマリオ・ルミュー以来という快挙でした。	his second goal of the night was his 60th of the season, becoming the first player to score 60 or more goals in a season since 1995-96, when Jaromir Jagr and Mario Lemieux each reached that milestone.
A1GPニュージーランドチームのコ・ドライバーであるジョニー・リードは本日、48年以上の歴史があるニュージーランドのオークランド・ハーバー・ブリッジを違反なく最速で駆け抜け、歴史に名を刻みました。	Jonny Reid, co-driver for the A1GP New Zealand team, today made history by driving the fastest over the 48-year-old Auckland Harbour Bridge, New Zealand, legally.
リード氏は、ニュージーランドのA1GPカーである「ブラックビューティー」で時速160 km以上で7回も橋を渡る走行に成功しました。	Mr Reid managed to drive the New Zealand's A1GP car, Black Beauty at speeds over 160km/h seven times over the bridge.
ニュージーランドの警察は、ブラックビューティーの速度が低いため、速度計測器でリード氏の速度を確認するのに苦労したそうで、警察がリード氏の速度を確認できたのは、時速160 kmまで減速したときだけだったそうです。	The New Zealand police had trouble using their speed radar guns to see how fast Mr Reid was going because of how low Black Beauty is, and the only time the police managed to clock Mr Reid was when he slowed down to 160km/h.
その日の未明、ジャルケはイタリアのカバーチアーノでシーズン前のトレーニング中で練習に励んでいました。彼は日曜日に予定されていたボロニア戦の試合を前にチームのホテルに滞在していました。	Jarque was practicing during pre-season training at Coverciano in Italy earlier in the day. He was staying in the team hotel ahead of a match planned for Sunday against Bolonia.
日曜日に予定されていたボローニャ戦の試合を前に彼はチームのホテルに宿泊していました。	He was staying in the team hotel ahead of a match planned for Sunday against Bolonia.
シューマッハは、F1選手権で7度の優勝を果たし、2006年に引退しましたが、負傷したフェリペ・マッサに代わって復帰する予定でした。	Schumacher who retired in 2006 after winning the Formula 1 championship seven times, was due to replace the injured Felipe Massa.
ブラジル人は2009年ハンガリーGPの事故で東部に重傷を負いました。	The Brazilian suffered a serious head injury after a crash during the 2009 Hungarian Grand Prix.
マッサは少なくとも2009年の残りのシーズンは欠場することになっている。	Massa is due to be out for at least the rest of the 2009 season.
ゴルフとラグビーがいずれもオリンピック競技に復帰する予定です。	Both golf and rugby are set to return to the Olympic Games.
国際オリンピック委員会は本日、ベルリンで開かれた理事会で、大会に含める種目を決議した。ラグビー（厳密にはラグビーユニオン）とゴルフは、他の5つの競技よりも優先的なオリンピック種目の候補として選ばれた。	The International Olympic Committee voted to include the sports at its executive board meeting in Berlin today. Rugby, specifically rugby union, and golf were selected over five other sports to be considered to participate in the Olympics.
スカッシュ、空手、ローラースポーツは、2005年にオリンピックから除外された野球やソフトボールと同じようにオリンピック種目の候補に挙がりました。	Squash, karate and roller sports tried to get onto the Olympic program as well as baseball and softball, which were voted out of the Olympic Games in 2005.
投票は、10月にコペンハーゲンで開催されるIOCの総会で承認されなければなりません。	The vote must still be ratified by the full IOC at it's October meeting in Copenhagen.
全員が女性の入賞を支持していたわけではありません。	Not all were supportive of the inclusion of the women’s ranks.
2004年のオリンピック銀メダリスト、アミール・カーンは、「心の底では、女性は戦うべきではないと思っている。それが本心です」と語りました。	2004 Olympic silver medallist Amir Khan said, "Deep down I think women shouldn’t fight. That’s my opinion."
彼のコメントにもかかわらず、彼はロンドンで開催されている2012年のオリンピックで英国の競争相手をサポートすると述べました。	Despite his comments he said he will be supporting the British competitors at the 2012 Olympics being held in London.
21歳のジーザスは昨年2017年1月に2700万ポンド（約2,700万円）と報じられた移籍金を払ってブラジルのクラブであるパルメイラスからマンチェスター・シティに移籍しました。	21-year-old Jesus joined Manchester City last year in January 2017 from Brazilian club Palmeiras for a reported fee of £27 million.
以降、このブラジル人選手は同クラブから53試合に出場し、24ゴールを決めています。	Since then, the Brazilian has featured in 53 matches for the club in all competitions and has scored 24 goals.
オリンピックで2つの金メダルを獲得した日本人柔道家の斉藤仁さんは54歳で亡くなりました。	Japanese judoka Hitoshi Saito, winner of two Olympic gold medals, has died at the age of 54.
死因は肝内胆管癌であったと発表されました。	The cause of death was announced as intrahepatic bile duct cancer.
火曜日に大阪で亡くなりました。	He died in Osaka on Tuesday.
斎藤氏はオリンピック金メダリスト、世界チャンピオンであると同時に、亡くなる前は全日本柔道連盟の練習委員長を務めていました。	As well as a former Olympic and World champion, Saito was the All Japan Judo Federation training committee chairman at the time of his death.
クロアチアの首都ザグレブで生まれたボベックは、パルチザンベオグラードで活躍していた頃に有名になりました。	Born in the Croatian capital, Zagreb, Bobek gained fame while playing for Partizan Belgrade.
1945年に彼らと合流し、1958年まで滞在した。	He joined them in 1945 and stayed until 1958.
在籍期間に468試合に出場し、403ゴールを記録した。	During his time with the team, he scored 403 goals in 468 appearances.
ボベックほどこのクラブで多くの出場回数やゴールを挙げた選手は他にいません。	No one else has ever made more appearances or scored more goals for the club than Bobek.
1995年にはパルチザン史上最高の選手に選ばれた。	In 1995 he was voted the best player in Partizan's history.
祝賀会は、世界的に有名なシルク・ドゥ・ソレイユの特別ショーから始まりました。	The celebrations started with a special show by the world-renowned group Cirque du Soleil.
次いで、イスタンブール国立交響楽団、ヤニサリーバンド、歌手のファティヒ・エルコッチとミュスルム・ギュルセスが登場しました。	It was followed by the Istanbul State Symphony Orchestra, a Janissary band, and the singers Fatih Erkoç and Müslüm Gürses.
続いて旋舞教団がステージに登場しました。	Then Whirling Dervishes took to the stage.
トルコの歌姫セゼン・アクスは、イタリアのテノール歌手アレッサンドロ・サフィーナやギリシャの歌手ハリス・アレクシウと共演しました。	Turkish diva Sezen Aksu performed with the Italian tenor Alessandro Safina and Greek singer Haris Alexiou.
最後にトルコのダンスチーム「ファイヤー・オブ・アナトリア」が「トロイ」を披露しました。	To finish, Turkish dance group Fire of Anatolia performed the show "Troy".
キャニオニングとは、渓流または乾いた峡谷を底まで下るスポーツです。	Canyoning (or: canyoneering) is about going in a bottom of a canyon, which is either dry or full of water.
キャニオニングは、水泳、クライミング、ジャンプの要素を組み合わせたスポーツです。始めるにあたっての基本トレーニングや体調に関する要件は（ロッククライミング、スキューバダイビング、アルペンスキー等に比べて）緩めです。	Canyoning combines elements from swimming, climbing and jumping--but requires relatively little training or physical shape to get started (compared to rock climbing, scuba diving or alpine skiing, for example).
ハイキングとは、野外で自然環境を楽しむ徒歩旅行ですが、通常はハイキングコースを歩くことになります。	Hiking is an outdoor activity which consists of walking in natural environments, often on hiking trails.
日帰りハイキングの距離は、1マイル未満の短い距離から1日で回れる程度の長距離までです。	Day hiking involves distances of less than a mile up to longer distances that can be covered in a single day.
歩きやすい道を日帰りでハイキングする場合、ほとんど準備は必要ありません。体調の良い人なら誰でも楽しむことができます。	For a day hike along an easy trail little preparations are needed, and any moderately fit person can enjoy them.
小さい子供がいる家族連れは、より入念な準備が必要かもしれませんが、赤ちゃんや未就学児の子供がいても、屋外で1日を楽しむことは簡単にできます。	Families with small children may need more preparations, but a day outdoors is easily possible even with babies and pre-school children.
国際的には、200近くの旅ラン運営組織があります。そのほとんどが独立系です。	Internationally, there are nearly 200 running tour organizations. Most of them operate independently.
Global Running Toursの後継となるGo Running Toursは、4大陸にわたり何十社もの旅ラン業者をネットワークで結んでいます。	The Global Running Tours successor, Go Running Tours networks dozens of sightrunning providers on four continents.
バルセロナの「Running Tours Barcelona」やコペンハーゲンの「Running Copenhagen」をルーツに、プラハを拠点とする「Running Tours Prague」などがすぐに参加しました。	With roots in Barcelona's Running Tours Barcelona and Copenhagen's Running Copenhagen, it was quickly joined by Running Tours Prague based in Prague and others.
米国体操連盟（USA Gymnastics）は、米国オリンピック委員会の書簡を支持し、選手全員のための安全な環境づくりを促進するためにオリンピックファミリーの絶対的な必要性を受け入れます。	USA Gymnastics supports the United States Olympic Committee's letter and accepts the absolute need of the Olympic family to promote a safe environment for all of our athletes.
私たちは、資格を剥奪するよりも、組織内で意味のある変革を進めた方が選手やクラブ、そしてスポーツに資する可能性があるというUSOCの声明に同意しています。	We agree with the USOC's statement that the interests of our athletes and clubs, and their sport, may be better served by moving forward with meaningful change within our organization, rather than decertification.
米国体操連盟は、ラリー・ナッサー氏の遺族が勇気を持って説明したような虐待がなぜ長期に渡って発覚しなかったかを明らかにするための第三者による調査に協力し、必要かつ適切な変化を受け入れる所存です。	USA Gymnastics supports an independent investigation that may shine light on how abuse of the proportion described so courageously by the survivors of Larry Nassar could have gone undetected for so long and embraces any necessary and appropriate changes.
米国体操連盟とUSOCは同じ目標を掲げています。アスリートが安全かつ前向きに力を発揮できる環境で夢を追いかけられるように、スポーツとしての体操やその他のスポーツをできるだけ安全なものにすることです。	USA Gymnastics and the USOC have the same goal — making the sport of gymnastics, and others, as safe as possible for athletes to follow their dreams in a safe, positive and empowered environment.
ロビン・ウタッパは、11本のフォーと2本のシックスを打って、わずか41球でイニング最高得点となる70ランを記録した。	Robin Uthappa made the innings highest score, 70 runs in just 41 balls by hitting 11 fours and 2 sixes.
中軸のバッツマン、サチン・テンドルカール、ラホール・ドラヴィッドが連携してうまく試合を運び、100ランを達成しました。	Middle order batsmen, Sachin Tendulkar and Rahul Dravid, performed well and made a hundred-run partnership.
しかし、キャプテンのウィケットを失った後、インドは7つのウィケットを失い、36ランしかできませんでした。	But, after losing the captain's wicket India only made 36 runs loosing 7 wickets to end the innings.
1日に授与されるメダルは18個のみなので、多くの国が表彰台に上がれませんでした。	With only eighteen medals available a day, a number of countries have failed to make the medal podium.
具体的には、昨日のスーパーGで女子スタンディングクラスでアンナ・ヨシェムセンが9位に終わったオランダや、同じイベントでカチャ・サーリネンが10位に終わったフィンランドなどです。	They include the Netherlands, with Anna Jochemsen finishing ninth in the women's standing class in the Super-G yesterday, and Finland with Katja Saarinen finishing tenth in the same event.
オーストラリアのミッチェル・ゴーリーはスーパーG男子スタンディングで11位に終わりました。チェコのオルドリッチ・イェリネクは、男子シングルスーパーGで16位に終わりました。	Australia's Mitchell Gourley finished eleventh in the men's standing Super-G. Czech competitor Oldrich Jelinek finished sixteenth in the men's sitting Super-G.
メキシコのアーリー・ベラスケスは、男子シッティングスーパーGで15位に終わりました。ニュージーランドのアダム・ホールは、男子スタンディング・スーパーGで9位に入賞しました。	Arly Velasquez of Mexico finished fifteenth in the men's sitting Super-G. New Zealand's Adam Hall finished ninth in the men's standing Super-G.
ポーランドの視覚障害者スキーヤー、マキエイ・クレツェルとガイドのアンナ・オガルジンスカはスーパーＧで13位に入賞した。韓国のパク・ジョンソークは、男子シッティング・スーパーＧで２４位に終わった。	Poland's men's visually impaired skier Maciej Krezel and guide Anna Ogarzynska finished thirteenth in the Super-G. South Korea's Jong Seork Park finished twenty-fourth in the men's sitting Super-G.
両選手がセットのすべてのサーブを1つずつ握った後、マレー選手がタイブレークで第1セットを失いました。	Murray lost the first set in a tie break after both men held each and every serve in the set.
第2セットでは、デル・ポトロが序盤から優位でしたが、6-6に追いつかれた後、またもやタイブレークが必要となりました。	Del Potro had the early advantage in the second set, but this too required a tie break after reaching 6-6.
ポトロは、この時点で肩の治療を受けていましたが、なんとか試合に復帰しました。	Potro received treatment to his shoulder at this point but managed to return to the game.
ジャンカルロ・フィジケラがマシンをコントロールできなくなり、スタート直後にレースから脱落しました。	Giancarlo Fisichella lost control of his car and ended the race very soon after the start.
チームメイトのフェルナンド・アロンソはレースの大半をリードしていましたが、ピットストップ直後に右フロントホイールの収まりが悪かったためか、レースから脱落しました。	His teammate Fernando Alonso was in the lead for most of the race, but ended it right after his pit-stop, probably because a badly tucked right front wheel.
ミハエル・シューマッハは、レース中に受けた度重なる衝撃でサスペンションが故障したため、アロンソの直後にレースから脱落しました。	Michael Schumacher ended his race not long after Alonso, because of the suspension damage in the numerous battles during the race.
水曜日のイベントの後、カルパネドは選手権で2つの個人レースに出場しました。	Beyond Wednesday's event, Carpanedo competed in two individual races at the Championships.
最初のレースはスラロームでしたが、彼女は最初の滑走でリタイア（Did Not Finish）となりました。このレースでは116人の選手のうち36人が同じ結果となりました。	Her first was the Slalom, where she earned a Did Not Finish in her first run. 36 of the 116 competitors had the same result in that race.
もう1つのレースであるジャイアント・スラロームでは、総合タイムが4分41秒30で、1位のオーストリアのクラウディア・ローシュより2分11秒60遅れ、9位のハンガリーのギョンギ・ダニより1分09秒02遅れの4分41秒30で、女子シッティンググループの10位でフィニッシュしました。	Her other race, the Giant Slalom, saw her finish in tenth in the women's sitting group with a combined run time of 4:41.30, 2:11.60 minutes slower than first place finisher Austrian Claudia Loesch and 1:09.02 minutes slower than the ninth place finisher Gyöngyi Dani of Hungary.
女子シッティンググループでは4人のスキーヤーが滑走を終えられず、ジャイアントスラロームでは全117人中45人がランクインできなかった。	Four skiers in the women's sitting group failed to finish their runs, and 45 of the 117 total skiers in the Giant Slalom failed to rank in the race.
仲間のレスラーたちもルナに敬意を表しました。	Fellow wrestlers also paid tribute to Luna.
トミー・ドリーマーは「ルナは初代クイーン・オブ・エクストリームでした。私の最初のマネージャーでもありました。ルナは月が2つ出た夜に亡くなりました。彼女と同じようにかなりユニークな夜でした。強い女性でした。」と語っています。	Tommy Dreamer said "Luna was the first Queen of Extreme. My first manager. Luna passed away on the night of two moons. Pretty unique just like her. Strong woman."
ダスティン・「ゴールドダスト」・ラネルズは、「ルナは俺と同じくらい異常だった…あるいはそれ以上だったかも...彼女を愛しているし、彼女がいなくて寂しくなるよ…叶うならば、彼女には天国にいてほしい」とコメントしました。	Dustin "Goldust" Runnels commented that "Luna was as freaky as me...maybe even more...love her and will miss her...hopefully she's in a better place."
そのオリンピック金メダリストは、コモンウェルスゲームで100mと200m自由形と3つのリレーで泳ぐ予定でしたが、本人が訴えた症状から健康状態が疑われています。	The Olympic gold medalist was due to swim in the 100m and 200m freestyle and in three relays at the Commonwealth Games, but due to his complaints his fitness has been in doubt.
痛みを抑えるのに必要な薬がその大会で禁止されているため、彼は服用できませんでした。	He has been unable to take the drugs needed to overcome his pain as they are banned from the Games.
特別な交通機関は設けられておらず、地上の電車はウェンブリーには停車せず、地上に駐車場やパークアンドライド施設はありません。	No extra transport is being put on and overground trains will not stop at Wembley, and car parking and park-and-ride facilities are unavailable at the ground.
交通手段がないことへの懸念から、チームのサポーターが集まらないまま、閉ざされた会場での試合を余儀なくされる可能性が浮上してきました。	Fears of lack of transportation raised the possibility that the game would be forced to play behind closed doors without the team's supporters.
鐙（あぶみ）とは、鞍の両側に吊り下げて乗り手の足を支える部分のことです。	Stirrups are supports for the rider's feet that hang down on either side of the saddle.
これで乗り手はかなり安定しますが、乗り手の足が引っかかることがあるため、安全面での懸念が生じることがあります。	They provide greater stability for the rider but can have safety concerns due to the potential for a rider's feet to get stuck in them.
馬から放り出される瞬間に鐙に足が引っかかっていると、逃げようとする馬に引きずられてしまう恐れがあります。この危険を最小限に抑えるために、いくつもの安全対策を講じることができます。	If a rider is thrown from a horse but has a foot caught in the stirrup, they could be dragged if the horse runs away. To minimize this risk, a number of safety precautions can be taken.
まず、ほとんどの乗り手は、踵と滑らかでかなり狭目の靴底が付いた乗馬靴を履いています。	First, most riders wear riding boots with a heel and a smooth, quite narrow, sole.
次に、一部の鞍、特にイギリス製の鞍には安全バーが付いており、乗り手が落馬しそうになって後方に引っ張られると、あぶみの革が鞍から落ちるようになっています。	Next, some saddles, particularly English saddles, have safety bars that allow a stirrup leather to fall off the saddle if pulled backwards by a falling rider.
コチャモ渓谷 - 南米のヨセミテと呼ばれるチリの最高峰の登山地で、花崗岩の大きな壁や岩場の数々があります。	Cochamó Valley - Chile's premier climbing destination, known as the Yosemite of South America, with a variety of granite big walls and crags.
頂上から眺めると、息をのむような景色が広がります。世界各地の登山家たちが、無限の可能性を秘めた壁に囲まれ、新しいルートを確立し続けています。	Summits include breath-taking views from peaks. Climbers from all parts of the world are continually establishing new routes amongst its endless potential of walls.
スキーやスノーボードを含むダウンヒル・スノースポーツは、スキーやスノーボードを足に装着して雪に覆われた地形を滑り降りる人気のスポーツです。	Downhill snowsports, which include skiing and snowboarding, are popular sports involving sliding down snow-covered terrain with skis or a snowboard attached to your feet.
スキーは旅の主なアクティビティであり、「スキー狂」と呼ばれる多くの愛好家たちが、特定の場所でのスキーを中心とした休暇を計画しています。	Skiing is a major travelling activity with many enthusiasts, occasionally known as "ski bums," planning entire vacations around skiing at a particular location.
スキーの概念は非常に古く、洞窟に描かれたスキーヤーの絵は紀元前5000年にまでさかのぼります。	The idea of skiing is very old — cave paintings depicting skiers date back as far as 5000 BC!
滑降スキーのスポーツとしての歴史は少なくとも17世紀にまでさかのぼり、1861年にはオーストラリアでノルウェー人が最初のレクリエーション用スキークラブを開設しました。	Downhill skiing as a sport goes back to at least the 17th century, and in 1861 the first recreational ski club was opened by Norwegians in Australia.
スキーによるバックパック旅行：このアクティビティは、バックカントリースキー、スキー旅行、スキーハイキングとも呼ばれます。	Backpacking by ski: This activity is also called backcountry ski, ski touring or ski hiking.
アルペンスタイルのクロスカントリースキーや登山に関連するものですが通常は含まれず、後者は急峻な地形を上り下りにより頑丈なスキーとブーツが必要です。	It is related to but usually not involving alpine style ski touring or mountaineering, the latter ones done in steep terrain and requiring much stiffer skis and boots.
スキールートはハイキングルートのようなものと考えてください。	Think of the skiing route as of a similar hiking route.
条件が良ければ、徒歩よりも多少は長い距離を進めますが、整備されたコースで重いバックパックを背負わないクロスカントリースキーのようなスピードで走行できるのはごく稀です。	In good conditions you will be able to cover somewhat greater distances than walking – but only very seldom you will get the speeds of cross country skiing without a heavy backpack in groomed tracks.
