ヨーロッパにつながる光海底ケーブルとブロードバンド衛星のおかげで、グリーンランドでは人口の93%がインターネットに接続しています。	Thanks to undersea fiber optic cable links to Europe and broadband satellite, Greenland is well connected with 93% of the population having internet access.
ホテルや宿泊先（ゲストハウスや個人宅に滞在している場合）には無線LANやインターネットに接続されたPCが設置されている可能性が高く、どの集落にもインターネットカフェや公共の無線LANが設置されている場所があります。	Your hotel or hosts (if staying in a guesthouse or private home) will likely have wifi or an internet connected PC, and all settlements have an internet cafe or some location with public wifi.
前述したように、「エスキモー」という言葉は米国ではまだ受け入れられていますが、米国以外の北極圏（特にカナダ）の人々には軽蔑語と見なされています。	As mentioned above, though the word "Eskimo" remains acceptable in the United States, it is considered pejorative by many non-U.S. Arctic peoples, especially in Canada.
グリーンランドの先住民が使う言葉を耳にすることがあるかもしれませんが、外国人が使うのは避けた方がいいでしょう。	While you may hear the word used by Greenlandic Natives, its use should be avoided by foreigners.
グリーンランドの先住民は、カナダではイヌイット、グリーンランドではグリーンランド人のカラアレク（複数形カラアリット）を自称しています。	The native inhabitants of Greenland call themselves Inuit in Canada and Kalaalleq (plural Kalaallit), a Greenlander, in Greenland.
グリーンランドでは犯罪や外国人に対する嫌悪はほとんどありません。町には「荒れた地域」すらありません。	Crime, and ill-will toward foreigners in general, is virtually unknown in Greenland. Even in the towns, there are no "rough areas."
寒冷気象は、準備不足の人が直面しうる唯一の本当の危険です。	Cold weather is perhaps the only real danger the unprepared will face.
寒い季節にグリーンランドを訪れる場合、（北上するほど寒くなることを考えると）十分に暖かい衣類を持っていくことが不可欠です。	If you visit Greenland during cold seasons (considering that the further north you go, the colder it will be), it is essential to bring warm enough clothing.
日の長い夏が続くと、十分な睡眠がとれず、健康上の問題につながる可能性があります。	The very long days in the summer can lead to problems getting sufficient sleep and associated health issues.
夏季には、北欧の蚊にも注意しましょう。蚊は病気を媒介することはありませんが、刺されると腫れることがあります。	During the summer, also watch out for the Nordic mosquitoes. Although they do not transmit any diseases, they can be irritating.
サンフランシスコの経済は、同都市が世界的な観光地であることと切り離せませんが、その経済は多様化しています。	While San Francisco's economy is linked to it being a world-class tourist attraction, its economy is diversified.
最大の雇用セクターは、専門サービス、政府、金融、貿易、観光です。	The largest employment sectors are professional services, government, finance, trade, and tourism.
音楽、映画、文学、大衆文化に頻繁に登場することで、サンフランシスコとそのランドマークは世界中に知られるようになりました。	Its frequent portrayal in music, films, literature and popular culture has helped make the city and its landmarks known throughout the world.
サンフランシスコは、多数のホテル、レストラン、一流の式場・展示会場など、大規模な観光インフラを開発してきました。	San Francisco has developed a large tourist infrastructure with numerous hotels, restaurants, and top-notch convention facilities.
サンフランシスコはその他のアジア料理でも全米で指折りの都市であり、韓国料理、タイ料理、インド料理、日本料理など各国の店が揃っています。	San Francisco is also one of the best places in the nation for other Asian cuisine: Korean, Thai, Indian, and Japanese.
ウォルト・ディズニー・ワールドへの旅行は、アメリカ人家族の多くにとって大巡礼のようなものでます。	Traveling to Walt Disney World represents a major pilgrimage for many American families.
「典型的」な観光は、オーランド国際空港に乗り入れ、ディズニーワールド内にあるホテルまでバスでに移動し、ディズニーワールドから出ることなく約1週間を過ごし、帰宅するというものです。	The "typical" visit involves flying into Orlando International Airport, busing to an on-site Disney hotel, spending about a week without leaving Disney property, and returning home.
無限のバリエーションがありますが、ほとんどの人にとって「ディズニーワールドに行く」ことを話題にしていることに変わりはないのです。	There are infinite variations possible, but this remains what most people mean when they talk of "going to Disney World".
eBayやCraigslistなどのオークションサイトで販売されオンラインで購入できる入場券の多くは使いかけの複数日分のパークホッパーチケットです。	Many tickets sold online through auction websites such as eBay or Craigslist are partially used multi-day park-hopper tickets.
これは非常に一般的な行為ですが、ディズニーでは禁止されており、チケットの譲渡はできません。	While this is a very common activity, it is prohibited by Disney: the tickets are non-transferable.
グランドキャニオンのふもとにキャンプする場合は、バックカントリー許可証が必要です。	Any camping below the rim in Grand Canyon requires a backcountry permit.
峡谷保護のために許可証の交付は限定されており、申し込みの受け付けは開始月の4か月前の月の1日からです。	Permits are limited to protect the canyon, and become available on the 1st day of the month, four months prior to the start month.
例えば、開始日が5月のバックカントリー許可証は1月1日から入手可能です。	Thus, a backcountry permit for any start date in May becomes available on 1 Jan.
最も人気のある場所（ファントムランチに隣接するブライトエンジェルキャンプ場など）は、通常、予約受付開始の初日に満員になります。	Space for the most popular areas, such as the Bright Angel Campground adjacent to Phantom Ranch, generally fill up by the requests received on first date they are opened to reservations.
予約なしの先着順でご利用いただける申請の許可証には数に限りがあります。	There are a limited number permits reserved for walk-in requests available on a first come, first served basis.
車でアフリカ南部に入るというのは、この地域の美しいものを観光できるだけでなく、通常の観光ルートから外れた場所にも行けるすごい方法です。	Entering Southern Africa by car is an amazing way to see all the region's beauty as well as to get to places off the normal tourist routes.
慎重に計画を立てれば普通の車でも可能ですが、四駆で行くことをお勧めします。多くの場所はホイールベースの長い四駆でなければたどり着けません。	This can be done in a normal car with careful planning but a 4x4 is highly advised and many locations are only accessible with a high wheel base 4x4.
アフリカ南部は安定していますが、隣国すべてが安定しているわけではないので注意しましょう。	Keep in mind while planning that although Southern Africa is stable not all neighboring countries are.
ビザの要件や申請にかかる費用は国ごとに異なり、また出身国にも左右されます。	Visa requirements and costs vary from nation to nation and are affected by the country you come from.
また、国ごとに法律で車内に備えるべき緊急用品を定めています。	Each country also has unique laws requiring what emergency items need to be in the car.
ビクトリアフォールズは、ジンバブエの西部にある町で、ザンビアのリビングストンとの国境を越えたボツワナに近くにあります。	Victoria Falls is a town in the western portion of Zimbabwe, across the border from Livingstone, Zambia, and near Botswana.
その町は滝のすぐ隣にあるため、滝が主な観光名所ですが、冒険を求める人も観光を楽しむ人もこの人気の観光地に長期滞在することができます。	The town lies immediately next to the falls, and they are the major attraction, but this popular tourist destination offers both adventure seekers and sightseers plenty of opportunities for a longer stay.
雨季（11月～3月）は水量が増え、滝はよりドラマチックになります。	In the rainy season (November to March), the water volume will be higher and the Falls will be more dramatic.
橋を渡ったり、滝の近くの曲がりくねった小道を歩いたりすると間違いなく濡れます。	You are guaranteed to get wet if you cross the bridge or walk along the trails winding near the Falls.
一方で、水量が非常に多いため、実際の滝をはっきりと見ることはできないでしょう。それだけ多くの水が流れているためです。	On the other hand, it is precisely because the volume of water is so high that your viewing of the actual Falls will be obscured—by all the water!
ツタンカーメンの墓（KV62）。KV62は、ハワード・カーター氏が1922年に若い王の埋葬品をほぼ無傷の状態で発見した墓として知られています。	Tomb of Tutankhamun (KV62). KV62 may be the most famous of the tombs in the Valley, the scene of Howard Carter's 1922 discovery of the almost intact royal burial of the young king.
しかし、他の王家の墓のほとんどに比べ、ツタンカーメンの墓は、はるかに小さく、限られた装飾しかないことから、訪れる価値はほとんどありません。	Compared to most of the other royal tombs, however, the tomb of Tutankhamun is barely worth visiting, being much smaller and with limited decoration.
棺から取り出す際にミイラが負った損傷の証拠を見たいと思っていた人は誰もが、頭部と肩しか見えないので、がっかりするでしょう。	Anyone interested in seeing evidence of the damage to the mummy done during attempts to remove it from the coffin will be disappointed as only the head and shoulders are visible.
この墓の素晴らしい宝物は、もはやその中にはなく、カイロのエジプト博物館に移されています。	The fabulous riches of the tomb are no longer in it, but have been removed to the Egyptian Museum in Cairo.
時間的に余裕のない観光客は、他の場所で過ごした方が良いでしょう。	Visitors with limited time would be best to spend their time elsewhere.
シェムリアップの南西12 kmに位置するプノンクロム。丘の頂上にあるこの寺院は、9世紀末にヤソヴァルマン王の時代に建てられました。	Phnom Krom, 12 km southwest of Siem Reap. This hilltop temple was built at the end of the 9th century, during the reign of King Yasovarman.
寺院の陰鬱な雰囲気とトンレサップ湖の眺めは、丘に登るだけの価値があります。	The gloomy atmosphere of the temple and the view over the Tonle Sap lake make the climb to the hill worthwhile.
湖への船旅と組み合わせてここを訪れるのも便利です。	A visit to the site can be conveniently combined with a boat trip to the lake.
寺院に入るにはアンコールパスと呼ばれる入場券が必要なので、トンレサップを訪れる際には忘れずにパスポートを携帯しましょう。	The Angkor Pass is needed to enter the temple so do not forget to bring your passport along when heading to Tonle Sap.
エルサレムはイスラエルの首都でありかつ最大都市ですが、他国のほとんどや国連から正式に首都として認められていないのが現状です。	Jerusalem is the capital and largest city of Israel, though most other countries and the United Nations do not recognize it as Israel's capital.
ユダヤの丘陵地帯にある古代都市には、何千年にもわたる魅力的な歴史があります。	The ancient city in the Judean Hills has a fascinating history spanning thousands of years.
ユダヤ教、キリスト教、イスラム教という三大一神教の聖地が集まったこの都市は、国の精神的、宗教的、文化的な中心地としての役割を果たしています。	The city is holy to the three monotheistic religions - Judaism, Christianity and Islam, and serves as a spiritual, religious, and cultural center.
都市の宗教的意義、そして特に旧市街地にある多くの遺跡や史跡により、エルサレムはイスラエルの主要な観光地の1つとなっています。	Due to the religious significance of the city, and in particular the many sites of the Old City area, Jerusalem is one of the main tourist destinations in Israel.
エルサレムには、数多くの歴史的、考古学的、文化的遺跡があり、活気に溢れた賑やかな商店街、カフェ、レストランがあります。	Jerusalem has many historic, archeological and cultural sites, along with vibrant and crowded shopping centers, cafés, and restaurants.
エクアドルでは、キューバ人が国際空港や辺境の入国ポイントを経由してエクアドルに入国する前に、招待状を受け取ることを義務付けています。	Ecuador requires that Cuban citizens receive an invitation letter prior to entering Ecuador through international airports or frontier admission points.
この書簡はエクアドル外務省によって合法化され、一定の要件を満たさなければなりません。	This letter must be legalized by the Ecuadorian Ministry of Foreign Affairs, and comply with certain requirements.
これらの要件は、両国間に組織的な移民の流れが生まれるように設計されています。	These requirements are designed to provide an organized migratory flow between both countries.
米国のグリーンカードを保有するキューバ市民は、エクアドル領事館を訪れて免除を受ける必要があります。	Cuban citizens who are US green card holders should visit an Ecuadorian Consulate to obtain an exemption to this requirement.
旅行日からパスポートの有効期限まで6か月以上なければなりません。滞在期間を証明するには、復路または第三国行きの航空券が必要です。	Your passport must be valid for at least 6 months beyond your travel dates. A round/onward trip ticket is needed to prove the length of your stay.
人数の多い団体ならばツアーがお得になるので、1人旅や友人と2人で旅行する代わりに、寄り集まって4～6人の団体で参加すれば、1人当たりの料金がお得になります。	Tours are cheaper for larger groups, so if you're by yourself or with just one friend, try to meet other people and form a group of four to six for a better per-person rate.
しかし、この場合は警戒心を解いてはいけません。多くの場合、観光客はごちゃ混ぜに乗車させられるからです。	However, this shouldn't really be off your concern, because often tourists are shuffled around to fill the cars.
実際には、人を騙してもっと料金を払わなければならないと思い込ませる方法のようです。	It seems actually to be more a way of tricking people into believing they have to pay more.
マチュピチュの北端にそびえ立つこの険しい山は、遺跡を撮影した多くの写真の背景に映りこんでいます。	Towering above the north end of Machu Picchu is this steep mountain, often the backdrop to many photos of the ruins.
下から見ると少し手ごわい感じがしますが、体力のある人ならば45分程度で登れるはずです。	It looks a bit daunting from below, and it is a steep and difficult ascent, but most reasonably fit persons should be able to make it in about 45 minutes.
道の大部分には石段が敷かれ、急勾配の区間では鋼鉄製ケーブルが手すりとして設置されています。	Stone steps are laid along most of the path, and in the steeper sections steel cables provide a supporting handrail.
とはいえ、息切れすることも予想され、特に急勾配では、濡れているとすぐに危険度が増すので注意しましょう。	That said, expect to be out of breath, and take care in the steeper portions, especially when wet, as it can become dangerous quickly.
頂上近くに小さな洞窟があり、そこを通過しなければなりませんが、極めて天井が低くて狭い洞窟です。	There's a tiny cave near the top that must be passed through, it is quite low and a rather tight squeeze.
1835年にチャールズ・ダーウィンがそうしたように、ガラパゴスの遺跡や野生生物を見るには船が最適です。	Seeing the sites and wildlife of the Galapagos is best done by boat, just as Charles Darwin did it in 1835.
ガラパゴス海域には60隻以上のクルーズ船が就航しており、大きさは8人乗りから100人乗りまでさまざまです。	Over 60 cruise ships ply the Galapagos waters - ranging in size from 8 to 100 passengers.
ほとんどの人は事前に席を予約をします（最盛期には船が満席になることが多いからです）。	Most people book their place well in advance (as the boats are usually full during the high season).
予約をする際には、代理店がガラパゴスを専門に扱い、多種多様な船に精通していることを確認してください。	Be sure the agent through whom you book is a Galapagos specialist with a good knowledge of a wide variety of ships.
そうすることで、お客様の具体的な興味や制約に合わせて、最も適した船を選ぶことができます。	This will ensure that your particular interests and/or constraints are matched with the ship most suitable to them.
16世紀にスペイン人が入植するまで、チリ北部はインカの支配下にあり、チリの中央部と南部には先住民族のアラウカ人（マプチェ族）が住んでいました。	Before the Spanish arrived in the 16th century, northern Chile was under Inca rule while the indigenous Araucanians (Mapuche) inhabited central and southern Chile.
マプチェ族は、チリ独立後までスペイン語族による支配下に、完全には吸収されなかった最後の独立系アメリカ先住民族の1つでもあります。	The Mapuche were also one of the last independent American indigenous groups, that were not fully absorbed into Spanish-speaking rule until after Chile's independence.
チリは1810年（ナポレオン戦争でスペインの中央政府が何年も機能しなかった頃）に独立を宣言しましたが、1818年までスペインに対して決定的な勝利を収めることはできませんでした。	Although Chile declared independence in 1810 (amid the Napoleonic wars that left Spain without a functioning central government for a couple of years), decisive victory over the Spanish was not achieved until 1818.
ドミニカ共和国（スペイン語：República Dominicana）は、カリブ海に浮かぶ国で、ヒスパニオラ島をハイチと分け合って島の東半分を占めています。	The Dominican Republic (Spanish: República Dominicana) is a Caribbean country that occupies the eastern half of the island of Hispaniola, which it shares with Haiti
白い砂浜と山岳風景のほかに、この国にはアメリカ大陸で最古のヨーロッパ風都市があり、現在ではサントドミンゴの一部となっています。	Besides white sand beaches and mountain landscapes, the country is home to the oldest European city in the Americas, now part of Santo Domingo.
この島に最初に住み着いたのは、タイノー族とカリブ族でした。カリブ族は、紀元前1万年頃に島に到着したアラワカン語を話す民族でした。	The island was first inhabited by the Taínos and Caribes. The Caribes were an Arawakan-speaking people who had arrived around 10,000 BCE.
タイノ族の人口はヨーロッパの探検隊が到着してから数年のうちに著しく減少しましたが、その原因はスペインの征服者たちが持ち込んだ伝染病でした。	Within a few short years following the arrival of European explorers, the population of Tainos had significantly been reduced by the Spanish conquerors
バルトロメ・デ・ラス・カサス（Tratado de las Indias）によれば、1492年から1498年の間にスペインの征服者たちが約10万人のタイノ人を殺害したそうです。	Based on Fray Bartolomé de las Casas (Tratado de las Indias) between 1492 and 1498 the Spanish conquerors killed around 100,000 Taínos.
ウニオン庭園。この空間は17世紀に建てられた修道院のアトリウムであり、唯一現存する建物はテンプロ・デ・サンディエゴがです。	Jardín de la Unión. This space was built as the atrium for a 17th-century convent, of which the Templo de San Diego is the sole surviving building.
今では中央広場として機能し、昼夜を問わず常にさまざまな活動に利用されています。	It now functions as the central plaza, and always has a lot of things going on, day and night.
庭園の周りにはレストランが何件もあり、午後や夕方には中央の見晴台で無料のコンサートが開かれることもあります。	There are a number of restaurants surrounding the garden, and in the afternoons and evening there free concerts are often given from the central gazebo.
キスの小路（Callejon del Beso）。わずか69センチで区切られた2つのバルコニーには、古くから愛の伝説があった場所です。	Callejon del Beso (Alley of the Kiss). Two balconies separated by only 69 centimeters is home of an old love legend.
数ペニー払えば、子供たちが語を聞かせてくれるでしょう。	For a few pennies some children will tell you the story.
ボーエン島は、カヤック、ハイキング、買い物、食事などを楽しめる日帰り旅行や週末のお出かけに人気のスポットです。	Bowen Island is a popular day trip or weekend excursion offering kayaking, hiking, shops, restaurants, and more.
この本格的なコミュニティはバンクーバー沖のハウ・サウンドに位置し、バンクーバーの商業地区にあるグランビル島から定期的に運航している水上タクシーで簡単に訪れることができます。	This authentic community is located in Howe Sound just off Vancouver, and is easily accessed via scheduled water taxis departing Granville Island in downtown Vancouver.
アウトドアを楽しむなら、シー・トゥ・スカイ回廊のトレッキングは欠かせません。	For those who enjoy outdoor activities, a trek up the Sea to Sky corridor is essential.
ウィスラー（バンクーバーから車で1時間半）は物価高ですが、2010年に冬季オリンピックが開催されたことで有名です。	Whistler (1.5 hour drive from Vancouver) is expensive but well-known because of the 2010 Winter Olympics.
冬には北米で最高のスキーを楽しみ、夏には本格的なマウンテンバイクに乗ってみましょう。	In the winter, enjoy some of the best skiing in North America, and in the summer try some authentic mountain biking.
事前に予約が必要です。シレーナに宿泊するには許可証が必要なのです。	Permits must be reserved in advance. You must have a permit to stay overnight at Sirena.
シレナはキャンプに加えて、寮宿泊や温かい食事を提供している唯一の森林管理施設です。ラ・レオナ、サン・ペドリロ、ロス・パトスはキャンプ場のみで、食事サービスはありません。	Sirena is the only ranger station that offers dormitory lodging and hot meals in addition to camping. La Leona, San Pedrillo, and Los Patos offer only camping with no food service.
プエルトヒメネスの森林管理移設から直接公園利用許可証を入手できますが、クレジットカードは利用できません。	It is possible to secure park permits directly from the Ranger Station in Puerto Jiménez, but they do not accept credit cards
公園管理局（MINAE）では、到着予定日の1か月前から公園許可証発行の申請を受け付けます。	The Park Service (MINAE) does not issue park permits more than one month in advance of anticipated arrival.
カフェネット・エル・ソルでは、30ドルで予約を受け付けており、1日券なら10ドルです。詳細についてはコルコバドのページをご覧ください。	CafeNet El Sol offers a reservation service for a fee of US$30, or $10 for one-day passes; details on their Corcovado page.
クック諸島は、南太平洋の中央に位置するポリネシアに属し、ニュージーランドと自由連合を結んだ島国です。	The Cook Islands are an island country in free association with New Zealand, located in Polynesia, in the middle of the South Pacific Ocean.
クック諸島は、220万平方キロメートルの海に広がる15の島々からなる群島です。	It is an archipelago with 15 islands spread out over 2.2 million km2 of ocean.
ハワイと同じタイムゾーンなので、島は「南半球のハワイ」と考えられることがあります。	With the same time zone as Hawaii, the islands are sometimes thought of as "Hawaii down under".
小さいながらもここを訪れると、年配の旅行客の中には、大きな観光ホテルなどが開発されていなかった州制施行前のハワイを思い出す人もいます。	Though smaller, it reminds some elderly visitors of Hawaii before statehood without all the large tourist hotels and other development.
クック諸島は15の島からなり、島に都市はあません。主な島はラロトンガ島とアイトゥタキ島です。	The Cook Islands do not have any cities but are composed of 15 different islands. The main ones are Rarotonga and Aitutaki.
今日の先進国では、豪華な宿と朝食を提供することが一種の芸術形態にまで進化しています。	In developed countries today, providing deluxe bed and breakfasts has been raised to a sort of art-form.
高級B&Bが主として寝具と朝食の2つの要素で競争しているのは明らかです。	At the top end, B&Bs obviously compete mainly on two main things: bedding and breakfast.
そのため、そうした最高級の施設では、豪華極まりない寝具や手作りの掛け布団やアンティークのベッドを目にすることもあるでしょう。	Accordingly, at the finest such establishments one is apt to find the most luxurious bedding, maybe a handmade quilt or an antique bed.
朝食には、地元の旬の食材を使った料理や宿の特別料理が並ぶことがあります。	Breakfast may include seasonal delights of the region or the host's speciality dish.
アンティーク調の家具や手入れの行き届いた敷地、プールなどがある歴史的な古い建物が舞台かもしれません。	The setting might be an historic old building with antique furnishings, manicured grounds and a swimming pool.
自分の車に乗り込み、長いドライブ旅行に向かうのは、そのシンプルさに内在する魅力があります。	Getting into your own car and heading off on a long road trip has an intrinsic appeal in its simplicity.
大型車とは違い、マイカーの運転にはすでに慣れており、その限界を知っているでしょう。	Unlike larger vehicles, you are probably already familiar with driving your car and know its limitations.
私有地であれ、どんな規模の町であれ、テントを張れば、すぐに人目についてしまいます。	Setting up a tent on private property or in a town of any size can easily attract unwanted attention.
要するに、車で行くのは長旅にはもってこいの方法なのですが、それ自体で「キャンプ」をすることはめったにありません。	In short, using your car is a great way to take a road trip but seldom in itself a way to "camp".
大型のミニバンやSUV、セダン、ステーションワゴンなど、座席を倒せる車であれば、カーキャンプも可能です。	Car camping is possible if you have a large minivan, SUV, Sedan or Station Wagon with seats that lay down.
第二次世界大戦前の19世紀から20世紀初頭にかけて利用された蒸気鉄道や外洋定期船の黄金時代の遺産を受け継いでいるホテルもあります。	Some hotels have a heritage from the golden age of steam railways and ocean liners; before the Second World War, in the 19th or early 20th centuries.
これらのホテルには、当時の富裕層や著名人が滞在し、高級な食事やナイトライフを楽しむことが多かったとされます。	These hotels were where the rich and the famous of the day would stay, and often had fine dining and nightlife.
昔ながらの建具が備え付けられ、最新のアメニティはなく、そしてある種の熟成した優雅な佇まいであることも、こうしたホテルの個性の一部です。	The old fashioned fittings, the lack of the latest amenities, and a certain graceful agedness are also part of their character.
通常は個人が所有していますが、来訪した国家元首やその他の要人を受け入れることもあります。	While they are usually privately owned, they sometimes accommodate visiting heads of state and other dignitaries.
資金的に余裕のある旅行者は、これらのホテルに宿泊しながら世界一周空の旅を利用するのもいいかもしれません。	A traveller with piles of money might consider a round the world flight, broken up with stays in many of these hotels.
おもてなし交流ネットワークとは、旅行者が訪れる都市で地元の人と旅行者をつなぐ組織のことです。	A hospitality exchange network is the organization that connects travelers with locals in the cities they are going to visit.
このようなネットワークに参加するには、通常、オンライン申込書に記入するだけですが、ネットワークによっては追加の認証や検証が必要になります。	Joining such a network usually just requires filling out an online form; although some networks offer or require additional verification.
利用可能な宿泊先の一覧は、印刷物やオンラインで提供され、他の旅行者による評価や意見が掲載されることもあります。	A listing of available hosts is then provided either in print and/or online, sometimes with references and reviews by other travelers.
カウチサーフィンは、コンピュータプログラマーのケイシー・フェントンがアイスランド行きの格安航空券を見つけたけれども宿泊先が見つらなかった経験から2004年1月に立ち上げたコミュニティです。	Couchsurfing was founded in January 2004 after computer programmer Casey Fenton found a cheap flight to Iceland but did not have a place to stay.
地元の大学生にメールで問い合わせたところ、圧倒的な数の無料宿泊の誘いを受けました。	He emailed students at the local university and received an overwhelming number of offers for free accommodation.
ホステルは主として若者を対象とした宿であり、典型的な宿泊客は20代ですが、年配の旅行者も多く見られます。	Hostels cater primarily to young people – a typical guest is in their twenties – but you can often find older travellers there too.
子供連れはめったに見られませんが、ホステルによっては個室での宿泊を許可しているところもあります。	Families with children are a rare sight, but some hostels do allow them in private rooms.
中国の北京市は2022年に冬季オリンピックの開催都市となる予定であり、夏季と冬季の両方のオリンピックを開催した初の都市となります。	The city of Beijing in China will be the host city of the Olympic Winter Games in 2022, which will make it the first city to have hosted both the summer and winter Olympics.
北京では開会式、閉会式、屋内氷上競技が催されます。	Beijing will host the opening and closing ceremonies and the indoor ice events.
他にも北京から約220キロ（140マイル）離れた張家口市の太子城スキー場でスキー大会が開催されます。	Other skiing events will be at the Taizicheng ski area in Zhangjiakou, about 220 km (140 miles) from Beijing.
ほとんどの寺院では、11月末から5月中旬にかけて毎年例祭があり、年間行事予定は寺院ごとに異なります。	Most of the temples do have an Annual festival starting from November end to Mid of May, which varies according to each temple's annual calendar.
寺院の例祭のほとんどは、寺院ごとの記念日、主宰神の誕生日、その他の祝い事、または寺院に関連する他の主要行事の一環として催されます。	Most of the temple festivals is celebrated as part of temple's anniversary or presiding deity's birthday or any other major event associated with the temple.
ケララ州の寺院で開かれるお祭りは、着飾った象たちの行進や寺院のオーケストラによる演奏など、とても見応えがあります。	Kerala's temple festivals are very interesting to see, with regular procession of decorated elephants, temple orchestra and other festivities.
世界博覧会（通称は万国博覧会、または単に万博）は、芸術と科学を展示する大規模な国際的祭典です。	A World's Fair (commonly called World Exposition, or simply Expo) is large international festival of arts and sciences.
参加国は、世界の問題や自国の文化や歴史を紹介するために、国別のパビリオンで芸術的・教育的な展示を行っています。	Participating countries present artistic and educational displays in national pavilions to showcase world issues or their country's culture and history.
国際園芸博覧会は、園芸に特化した催しであり、花の展示、植物園、その他植物栽培に関わるあらゆるもが展示されます。	International Horticultural Expositions are specialised events which showcase floral displays, botanical gardens and anything else to do with plants.
理論的には（別の国で開催される限り）毎年開催できますが、実際にはそうではありません。	Although in theory they can take place annually (so long as they are in different countries), in practice they are not.
通常、これらのイベントは50ヘクタール以下の敷地で3～6か月間にわたって催されます。	These events normally last anywhere between three and six months, and are held on sites no smaller than 50 hectares.
野生動物は写真家にとって最も難しいモチーフの1つであり、撮影には幸運、忍耐、経験、良い機材が揃わなければなりません。	Wildlife is among the most challenging motifs for a photographer, and needs a combination of good luck, patience, experience and good equipment.
野生動物の写真は当たり前のものと思われがちですが、一般的な写真と同じように、一枚の写真には語りつくせないほどの価値があります。	Wildlife photography is often taken for granted, but like photography in general, a picture is worth a thousand words.
野生動物の撮影には長めの望遠レンズが必要になることが多いですが、鳥の群れや小さな生き物には別のレンズが必要になります。	Wildlife photography often requires a long telephoto lens, though things like a flock of birds or a tiny creature need other lenses.
珍しい動物は見つけにいものが多く、公園が商業目的での写真撮影を制限する規則を設けていることもあります。	Many exotic animals are hard to find, and parks sometimes have rules about taking photographs for commercial purposes.
野生動物には臆病なものも攻撃的なものもいます。環境は寒冷、高温または適応しにくいことがあります。	Wild animals might either be shy or aggressive. The environment might be cold, hot, or otherwise hostile.
世界には5,000以上の言語があり、そのうち5,000万人以上の話者がいる言語は20を超えます。	The world has over 5,000 different languages, including more than twenty with 50 million or more speakers.
また、書き言葉の方が話し言葉よりも理解しやすいことが多いでしょう。特に住所の場合がそうであり、住所は相手に聞き取りやすく発音するのが難しいものです。	Written words are often easier to understand than spoken words, also. This is especially true of addresses, which are often difficult to pronounce intelligibly.
多くの国では国民全体が英語に堪能であり、さらに多くの場合、特に若者たちには限られた知識しか期待できません。	Many entire nations are completely fluent in English, and in even more you can expect a limited knowledge - especially among younger people.
マンチェスター、ボストン、ジャマイカ人、またシドニーの出身者たちがトロントのレストランで揃ってテーブルを囲み、食事をする様子を想像してみてください。	Imagine, if you will, a Mancunian, Bostonian, Jamaican and Sydneysider sitting around a table having dinner at a restaurant in Toronto.
彼らは、それぞれの訛りや方言で故郷の話をしています。	They're regaling each other with stories from their hometowns, told in their distinct accents and local argot.
旅行前にも旅行中にも、考慮しなければならないことがたくさんあります。	There are many things you have to take into consideration before and when you travel somewhere.
旅行先では、「自国」とは違うことを予想しましょう。マナー、法律、食べ物、交通、宿泊施設、基準、言語など、あなたの居住地とはある程度異なります。	When you travel, expect things not to be like they are "back home". Manners, laws, food, traffic, lodging, standards, language and so on will to some extent differ from where you live.
現地の慣習に失望したり、嫌悪感を抱かないように、このことを常に心に留めておくべきことです。	This is something you always need to keep in mind, to avoid disappointment or perhaps even distaste over local ways to do things.
旅行代理店は19世紀から存在しています。自然、文化、言語、低所得国など、これまでに経験したことのない旅をお望みの旅行客は、旅行代理店を利用するのが良いでしょう。	Travel agencies have been around since the 19th century. A travel agent is usually a good option for a journey which extends beyond a traveller's previous experience of nature, culture, language or low-income countries.
ほとんどの代理店は、大半の定期予約を喜んで引き受けてくれますが、多くの代理店は、特定の種類の旅行、予算の範囲や目的地に特化しています。	Although most agencies are willing to take on most regular bookings, many agents specialise in particular types of travel, budget ranges or destinations.
自分好みの旅行を予約しやすい代理店を利用する方が良いでしょう。	It can be better to use an agent who frequently books similar trips to yours.
ウェブサイトや店頭で、代理店がどのような旅行を宣伝しているかを見てみましょう。	Take a look at what trips the agent is promoting, whether on a website or in a shop window.
必要に迫られたり、ライフスタイルやチャレンジのために、安く見たいと思っているのであれば、いくつかの方法があります。	If you want to see the world on the cheap, for necessity, lifestyle or challenge, there are some ways to do that.
基本的には、旅行中に仕事をするか、出費を抑えるかの2つに分かれ、この記事では後者に焦点を当てています。	Basically, they fall into two categories: Either work while you travel or try and limit your expenses. This article is focused on the latter.
快適さ、時間、予測可能性を犠牲にして出費をゼロに近づけたい方は、最低予算で旅行する方法をご覧ください。	For those willing to sacrifice comfort, time and predictability to push expenses down close to zero, see minimum budget travel.
このアドバイスは、旅行者が自分の利益のために窃盗、不法侵入、違法市場への参加、物乞い、またはその他の方法で他人から搾取しないことを前提としています。	The advice assumes that travellers do not steal, trespass, participate in the illegal market, beg, or otherwise exploit other people for their own gain.
入国審査場は通常、飛行機や船、その他の乗り物から降りて最初に立ち寄る場所です。	An immigration checkpoint is usually the first stop when disembarking from a plane, a ship, or another vehicle.
国境を越える列車に乗る場合には、運行中に検査を受けねばならないことがあるので、有効な身分証明書を携帯してください。	In some cross-border trains inspections are done on the running train and you should have valid ID with you when boarding one of those trains.
夜行寝台列車では、乗客の睡眠を妨げないように、車掌がパスポートを回収してくれることがあります。	On night sleeper trains, passports may be collected by the conductor so that you do not have your sleep interrupted.
登録はビザ取得のための追加要件です。国によっては、現地当局に滞在先と住所を登録しなければならない場合もあります。	Registration is an additional requirement for the visa process. In some countries, you must register your presence and address where you are staying with the local authorities.
そのためには、現地警察での申請書の記入や、入国管理局への訪問が必要になる場合があります。	This might require filling out a form with the local police or a visit to the immigration offices.
このような法律がある多くの国では、現地のホテルが登録を代行してくれます（ぜひ依頼してください）。	In many countries with such a law, local hotels will handle the registration (make sure to ask).
また、観光客向けの宿泊施設以外に滞在する場合にのみ登録が必要な場合もあります。ただし、法律上わかりにくい点が多いので事前に調べておきましょう。	In other cases, only those staying outside of tourist accommodations need to register.  However, this makes the law much more obscure, so find out beforehand.
建築は、建物の設計や建設に関係しています。場所によっては、建築物自体が観光名所となっています。	Architecture is concerned with the design and construction of buildings. The architecture of a place is often a tourist attraction in its own right.
多くの建物は見た目に美しく、高い建物からの眺めや位置に工夫を凝らした窓からの眺めは、見る者を魅了する美しさがあります。	Many buildings are quite beautiful to look at and the view from a tall building or from a cleverly-positioned window can be a beauty to behold.
建築には、都市計画、土木工学、装飾芸術、室内装飾、景観設計といった他分野と重複する要素がかなりあります。	Architecture overlaps considerably with other fields including urban planning, civil engineering, decorative arts, interior design and landscape design.
プエブロ集落の多くがどれほど離れた場所にあるかを考えれば、アルバカーキやサンタフェに向かわない限り、ナイトライフを十分に楽しむことはできないでしょう。	Given how remote many of the pueblos are, you won't be able to find a significant amount of nightlife without traveling to Albuquerque or Santa Fe.
しかし、上記のカジノのほぼすべてが飲み物を提供しており、そのいくつか（主にアルバカーキとサンタフェのすぐ近くにある大規模なカジノ）は有名ブランドのエンターテイメントを提供しています。	However, nearly all of the casinos listed above serve drinks, and several of them bring in name-brand entertainment (primarily the large ones immediately surrounding Albuquerque and Santa Fe).
注意：この辺りにある居酒屋は、州外から来た旅行客がたむろするのに必ずしも良い場所ではありません。	Beware: small-town bars here are not always good places for the out-of-state visitor to hang out.
1つには、ニューメキシコ州北部で飲酒運転が大きな問題となっており、田舎町のバーの付近に飲酒運転者が集中していることが挙げられます。	For one thing, northern New Mexico has significant problems with drunk driving, and the concentration of intoxicated drivers is high close to small-town bars.
不快な壁画や落書きはグラフィティと呼ばれます。	Unwanted murals or scribble is known as graffiti.
現代の問題からはほど遠いものの、ほとんどの人はスプレー塗料を使って公共物や他人の私有財産にいたずらをする若者を連想するのでしょう。	While it's far from a modern phenomenon, most people probably associate it with youth vandalizing public and private property using spray paint.
しかし、現在では、著名なグラフィティアーティスト、グラフィティイベント、そして専用の「合法的」な壁面が存在します。この文脈におけるグラフィティペインティングの多くは、判読不能な記号類ではなく美術品に類似する扱いとなります。	However, nowadays there are established graffiti artists, graffiti events and "legal" walls. Graffiti paintings in this context often resemble artworks rather than illegible tags.
ブーメラン投げは、多くの観光客が身につけたがる人気の技です。	Boomerang throwing is a popular skill that many tourists want to acquire.
手元に戻ってくるブーメランの投げ方を身につけたい場合は、戻ってくるのに適したブーメランを用意しておきましょう。	If you want to learn throwing a boomerang that comes back to your hand, make sure you have a suitable boomerang for returning.
オーストラリアで手に入るブーメランのほとんどは、実際は戻って来ません。初心者の方は、風の強い場所では投げない方が良いでしょう。	Most boomerangs available in Australia are in fact non-returning. It is best for beginners to not try throwing in windy
ハンギ料理は、地面に掘った穴を熱して食材を調理するものです。	A Hangi Meal is cooked in a hot pit in the ground.
掘った穴に火から取り出した焼け石を入れて加熱するか、または地熱で地面が自然と熱くなっている場所に穴を掘ることもあります。	The pit is either heated with hot stones from a fire, or in some places geothermal heat makes areas of ground naturally hot.
ハンギを使って伝統的な蒸し焼き料理を作ることもよくあります。	The hangi is often used to cook a traditional roast style dinner.
ロトルアには地熱ハンギを提供している場所がいくつもあり、クライストチャーチやウェリントンなどでは違ったハンギを試すことができます。	Several places in Rotorua offer geothermal hangi, while other hangi can be sampled in Christchurch, Wellington and elsewhere.
メトロレールには、ケープタウンとその周辺を結ぶ通勤電車があり、メトロプラス（通称ファーストクラス）とメトロ（通称サードクラス）の2つに分かれています。	MetroRail has two classes on commuter trains in and around Cape Town: MetroPlus (also called First Class) and Metro (called Third Class).
メトロプラスは、混雑が少なくて快適ですがやや割高で、それでもヨーロッパにおける通常のメトロ乗車券よりは安価です。	MetroPlus is more comfortable and less crowded but slightly more expensive, though still cheaper than normal metro tickets in Europe.
どの列車にもメトロプラスとメトロの両方の客車があり、メトロプラスの客車は常にケープタウンに一番近い列車の最後尾にあります。	Every train has both MetroPlus and Metro coaches; the MetroPlus coaches are always on the end of the train nearest Cape Town.
他人のために持ち歩く - 特に国境を越えるときは、絶対に手荷物から目を離してはいけません。	Carrying for others - Never let your bags out of your sight, especially when you are crossing international borders.
気付かないうちに自分が麻薬の運び屋として利用されている可能性があり、そうなったら大きなトラブルに巻き込まれることになるでしょう。	You could find yourself being used as a drug carrier without your knowledge, which will land you in a great deal of trouble.
麻薬探知犬は緊急出動を要請される可能性が常にあるので、列に並んで待機するのも仕事です。	This includes waiting in line, as drug-sniffing dogs could be used at any time without notice.
国によっては、初犯であっても、10年以上の懲役刑や死刑など、非常に厳しい罰則を設けています。	Some countries have exceedingly draconian punishments even for first time offenses; these can include prison sentences of over 10 years or death.
手荷物から目を放すと置き引きに狙われるだけでなく、爆弾の脅威を警戒している当局からも目をつけられる場合があります。	Unattended bags are a target for theft and can also attract attention from authorities wary of bomb threats.
自宅では、その土地の細菌に常にさらされているため、すでに免疫ができている可能性が非常に高いのです。	At home, due to this constant exposure to the local germs, odds are very high that you're already immune to them.
しかし、細菌学的な動物相を経験していない他の地域では、問題に直面する可能性がはるかに高いのです。	But in other parts of the world, where the bacteriological fauna are new to you, you're far more likely to run into problems.
また、気候が温暖であるほど、細菌は成長が速く、かつ体外でより長く生存します。	Also, in warmer climates bacteria both grow more quickly and survive longer outside the body.
かくして、デリー腹、ファラオの呪い、モンテズマの復讐などなどの異名で呼ばれる下痢に旅行者は苦しむ。	Thus the scourges of Delhi Belly, the Pharaoh's Curse, Montezuma's Revenge, and their many friends.
寒冷気候で呼吸器系の問題が起きやすいように、高温気候で腸の問題が起きるのはかなり一般的で、ほとんどの場合、明らかに迷惑を被りますが、本当に危険ではありません。	As with respiratory problems in colder climates, intestinal problems in hot climates are fairly common and in most cases are distinctly annoying but not really dangerous.
初めて途上国を旅行する場合、または世界各国の初めての地域を旅行する場合、潜在的なカルチャーショックを過小評価してはいけません。	If traveling in a developing country for the first time – or in a new part of the world – don't underestimate the potential culture shock.
落ち着きのある有能な旅行者の多くは、途上国の旅行で経験する目新しさに圧倒され、文化的な差異を埋めるためにすばやく微調整を重ねていきます。	Many a stable, capable traveler has been overcome by the newness of developing world travel, where many little cultural adjustments can add up quickly.
特に、最初の数日間は、慣れるために、欧風の高級なホテルや食事、サービスにお金をかけることを検討してみてはいかがでしょうか。	Especially in your initial days, consider splurging on Western-style and -quality hotels, food, and services to help acclimatize.
現地の動物相がわからない地域では、地面にマットレスやパッドを敷いて寝ないようにしましょう。	Do not sleep on a mattress or pad on the ground in areas where you do not know the local fauna.
キャンプ生活をする場合は、蛇やサソリなどから身を守るために、キャンプ用の簡易ベッドやハンモックを用意しましょう。	If you are going to camp out, bring a camp cot or hammock to keep you away from snakes, scorpions and such.
朝はリッチなコーヒー、夜はリラックスできるカモミールティーのアロマをお家いっぱいに広げましょう。	Fill your home with a rich coffee in the morning and some relaxing chamomile tea at night.
遠くに出歩かなくても、自分へのご褒美としていつもよりも時間をかけて特別な飲み物を淹れるなどして休暇を楽しめます。	When you're on a staycation, you have the time to treat yourself and take a few extra minutes to brew up something special.
もっと冒険したいと思ったら、この機会にスムージーを絞るかブレンドしてみてはいかがでしょうか。	If you're feeling more adventurous, take the opportunity to juice or blend up some smoothies:
日常生活に戻ったときに、朝食に簡単に作れる飲み物が見つかるかもしれません。	maybe you'll discover a simple beverage that you can make for breakfast when you're back to your daily routine.
飲酒文化が多様化している都市に住んでいる場合は、あまり行ったことのない近所の居酒屋やパブに行ってみましょう。	If you live in a city with a varied drinking culture, go to bars or pubs in neighborhoods you don't frequent.
医療専門用語に馴染みのない方のために付け加えると、感染性と伝染性という言葉は、異なる意味を持っています。	For those unfamiliar with medical jargon, the words infectious and contagious have distinct meanings.
感染症とは、ウイルス、細菌、真菌、その他の寄生虫などの病原体が体内に侵入して増殖し、症状が現れる病気です。	An infectious disease is one that is caused by a pathogen, such as a virus, bacterium, fungus or other parasites.
伝染病とは、感染者の近くにいることで感染しやすい病気のことです。	A contagious disease is a disease which is easily transmitted by being in the vicinity of an infected person.
多くの政府は、入出国者に様々な病気の予防接種を義務づけています。	Many governments require visitors entering, or residents leaving, their countries to be vaccinated for a range of diseases.
これらの要件は、旅行者がどの国を訪問したことがあるか、または訪問しようとしているかによって異なる場合があります。	These requirements may often depend on what countries a traveller has visited or intends to visit.
ノースカロライナ州シャーロットの魅力は、家族向けの択肢が豊富に揃っていてその質が高いことです。	One of strong points of Charlotte, North Carolina, is that it has an abundance of high-quality options for families.
他の地域からの移住者は、家族で暮らしやすいことを第一の理由に挙げていることが多く、観光客は子連れでも気軽に楽しめる街だと感じることが多いようです。	Residents from other areas often cite family-friendliness as a primary reason for moving there, and visitors often find the city easy to enjoy with children around.
アップタウン・シャーロットで利用できる子供向けの選択肢は過去20年間で指数関数的に増えました。	In the past 20 years, the amount of child-friendly options in Uptown Charlotte has grown exponentially.
シャーロットでは一般的に家族連れがタクシーを利用する習慣はありませんが、状況によっては利用できる場合もあります。	Taxis are not generally used by families in Charlotte, though they can be of some use in certain circumstances.
乗客が2人以上の場合には割増料金がかかるので、このオプションは割高になることがあります。	There is a surcharge for having more than 2 passengers, so this option might be more expensive than necessary.
今日の空の旅では、まず航空券を検索して価格を比較するのがふつうであり、航空会社に直接予約を入れることはほとんどありません。	Nowadays air travel is only rarely booked directly through the airline without first searching and comparing prices.
同じ便でも情報収集サイトによって大幅に価格が異なることがあるので、予約する前に検索結果を比較したり、航空会社自体のウェブサイトで確認することが大切です。	Sometimes the same flight can have vastly differing prices at various agregators and it pays to compare search results and to also look at the website of the airline itself before booking.
帰国時の入国審査は省略されたり、たいてい形式的にすまされますが、税関検査は面倒なものになる可能性があります。	While immigration check is usually absent or a formality when you arrive in your homeland, customs control can be a hassle.
持ち込み可のものと不可のを確認し、法律で定められた限度を超えるものは申告しましょう。	Make sure you know what you can and cannot bring in and declare anything over the legal limits.
旅行ライターになるための最も簡単な方法は、有名な旅行ブログのウェブサイトで腕を磨くことです。	The easiest way to get started in the business of travel writing is to hone your skills on an established travel blog website.
ウェブ上での書式設定や編集に慣れてきたら、後ほど自分のウェブサイトを作成できるかもしれません。	After you become comfortable with formatting and editing on the web, then later, you might create your own website.
アライアンスを組んでいるフリークエントフライヤーの航空会社は慎重に選ぶ必要があります。	You should choose your Frequent Flyer airline in an alliance carefully.
よく利用する航空会社に入会する方がわかりやすいと思われるかもしれませんが、航空会社ごとに特典が異なることが多く、同じアライアンス内の異なる航空会社の方がマイレージポイントがたまる場合があることを知っておくとよいでしょう。	Although you may think it is intuitive to join the airline you fly most, you should be aware that privileges offered are often different and frequent flyer points may be more generous under a different airline in the same alliance.
エミレーツ航空、エティハド航空、カタール航空、トルコ航空といった航空会社は、アフリカ行き路線の大幅な拡大を図っており、他のヨーロッパ航空会社よりもお得な料金でアフリカの主要都市への乗り継ぎ便を運航しています。	Airlines such as Emirates, Etihad Airways, Qatar Airways & Turkish Airlines have greatly expanded their services to Africa, and offer connections to many major African cities at competitive rates than other European airlines.
トルコ航空は2014年現在、アフリカ30カ国39都市に就航しています。	Turkish Airlines flies to 39 destinations in 30 African countries as of 2014.
さらに移動時間が長くなる場合は、アフリカまでの総運賃の見積もりが世界一周運賃と比較してどのくらいかを確認してください。	If you have additional travel time, check to see how your total fare quote to Africa compares with a round-the-world fare.
アフリカ以外の場所を訪れる場合、ビザの追加申請、出国税、地上交通費などの追加費用も忘れてはなりません。	Don't forget to add in the extra costs of additional visas, departure taxes, ground transportation, etc. for all those places outside of Africa.
南半球には大洋横断ルートがないので、完全に世界一周をしたい場合、運航便や目的地の選択肢が限られてきます。	If you want to fly around the world completely in the Southern Hemisphere, the choice of flights and destinations is limited due to the lack of transoceanic routes.
南半球の3つの海洋すべてを横断する便を就航している航空会社はありません（スカイチームはいずれの海洋を横断する便も就航していません）。	No airline alliance covers all three ocean crossings in the Southern Hemisphere (and SkyTeam covers none of the crossings).
しかし、スターアライアンスは、サンティアゴ・デ・チリからタヒチまでの南太平洋東部を除く全域を対象地域とし、サンティアゴ・デ・チリからタヒチまでの便はLATAMワンワールドが就航しています。	However, Star Alliance covers everything except the eastern South Pacific from Santiago de Chile to Tahiti, which is a LATAM Oneworld flight.
南太平洋や南米の西海岸を通り越したい場合、この便が唯一の選択肢というわけではありません（下記参照）。	This flight is not the only option if you want to skip the South Pacific and the west coast of South America. (see below)
1994年、アゼルバイジャンの民族的アルメニア人ナゴルノ・カラバフ地域は、アゼルバイジャン人と戦争をしました。	In 1994, the ethnically Armenian Nagorno-Karabakh region of Azerbaijan waged war against the Azeris.
アルメニア人の支援を得て、新しい共和国が誕生しました。しかし、アルメニアでさえその国を公式には認めていないのです。	With Armenian backing, a new republic was created. However, no established nation - not even Armenia - officially recognizes it.
この地域をめぐる外交論争により、アルメニアとアゼルバイジャンの関係性は悪化し続けています。	Diplomatic arguments over the region continue to mar relations between Armenia and Azerbaijan.
運河地区（オランダ語でGrachtengordel）は、17世紀に栄えた有名な地区でアムステルダムのビネンスタトを取り囲むように広がっています。	The Canal District (Dutch: Grachtengordel) is the famous 17th-century district surrounding the Binnenstad of Amsterdam.
地区全体が独自の文化的歴史的価値を持つことからユネスコの世界遺産に指定され、その資産価値は国内でも有数の高さを誇っています。	The whole district is designated as a UNESCO World Heritage Site for its unique cultural and historical value, and its property values are among the highest of the country.
イタリアのリグーリア州にあるチンクエ・テッレは「5つの土地」を意味し、オマッジョーレ、マナローラ、コルニリア、ヴェルナッツァ、モンテロッソという5つの小さな村が寄り添うようにできた沿岸沿いの地域です。	Cinque Terre, which means Five Lands, comprises the five small coastal villages of Riomaggiore, Manarola, Corniglia, Vernazza and Monterosso located in the Italian region of Liguria.
これらの村はユネスコの世界遺産に登録されています。	They are listed on the UNESCO World Heritage List.
何世紀にもわたって、人々は岩だらけ険しい地形に丁寧にテラスを築き、海を望む断崖絶壁までつなげました。	Over the centuries, people have carefully built terraces on the rugged, steep landscape right up to the cliffs that overlook the sea.
その魅力の一部は、目に見える企業開発がないことです。道や電車、船が村をつなぎ、外部から車が進入することはありません。	Part of its charm is the lack of visible corporate development. Paths, trains and boats connect the villages, and cars cannot reach them from the outside.
旅の途中、岩崎さんは何度もトラブルに見舞われました。	During his trip, Iwasaki ran into trouble on many occasions.
海賊に襲われたり、チベットで狂犬に襲われたり、ネパールでの結婚から逃れたり、インドで逮捕されたりしたのです。	He was robbed by pirates, attacked in Tibet by a rabid dog, escaped marriage in Nepal and was arrested in India.
オタワは二か国語が通じる魅力的なカナダの首都であり、カナダの過去と現在を紹介する美術館や博物館が数多くあります。	Ottawa is Canada's charming, bilingual capital and features an array of art galleries and museums that showcase Canada's past and present.
さらに南にはナイアガラの滝があり、北にはムスコカをはじめとする手つかずの自然美が広がっています。	Farther south is Niagara Falls and the north is home to the untapped natural beauty of the Muskoka and beyond.
これらすべてのおかげでオンタリオ州は際立ち、第三者から見て実にカナダらしい州だと考えられています。	All these things and more highlight Ontario as what is considered quintessentially Canadian by outsiders.
さらに北方の広い地域は人口が少なく、ほとんど人が住んでいない原生地域もあります。	Large areas further north are quite sparsely populated and some is nearly uninhabited wilderness.
多くの人が驚く人口比較：アメリカに住むアフリカ系アメリカ人の数はカナダ人の数を上回っています。	For a comparison of population that surprises many: There are more African Americans living in the US than there are Canadian citizens.
東アフリカ諸島は、アフリカ大陸東岸沖のインド洋にあります。	The East African Islands are in the Indian Ocean off the eastern coast of Africa.
マダガスカルは群を抜いて最大の島であり、野生生物の生息地としては独自の大陸です。	Madagascar is by far the biggest, and a continent on its own when it comes to wildlife.
小さい島々の大半は独立国か、またはフランスに関係する国々であり、有名な高級ビーチリゾートもあります。	Most of the smaller islands are independent nations, or associated with France, and known as luxury beach resorts.
また、アラブ人はこの地にイスラム教をもたらし、それはコモロとマヨットで広く受け入れられました。	The Arabs also brought Islam to the lands, and it took in a big way in the Comoros and Mayotte.
15世紀にポルトガルの探検家ヴァスコ・ダ・ガマがヨーロッパから喜望峰を経由してインドに到達する航路を発見し、そこからヨーロッパの影響力と植民地主義が始まりました。	European influence and colonialism began in the 15th century, as Portuguese explorer Vasco da Gama found the Cape Route from Europe to India.
北はサヘルと境界を接し、南と西は大西洋に囲まれた地域です。	In the north the region is bounded by the Sahel, and in the south and west by the Atlantic Ocean.
女性：女性の旅行客は、実際の婚姻関係に関わらず、既婚者であると表明することをお勧めします。	Women: It is recommended that any women travellers say that they are married, regardless of actual marital status.
指輪（あまり高そうでないもの）をしておくと効果的です。	It is helpful to also wear a ring (just not one that looks too expensive.
女性は文化の違いはハラスメントと呼ばれる行為にながりうることを女性は認識しておくべきであり、尾行されたり、腕を掴まれたりするのは珍しくありません。	Women should realize that cultural differences may result in what they would consider harassment and it is not uncommon to be followed, grabbed by the arm, etc.
男性の誘いを断るときには、臆することなく毅然とした態度で自分の立場を貫きましょう（文化の違いがあろうがなかろうが、強引な誘いになびく必要はありません！）。	Be firm in turning down men, and don't be afraid to stand your ground (cultural differences or not, it doesn't make it ok!).
カサブランカ現代都市の基礎は、紀元前10世紀にベルベル人の漁師たちが築いたものでアンファと呼ばれました。その後、フェニキア人、ローマ人、そしてメレニッド朝がこの地を戦略的な港として利用しました。	The modern city of Casablanca was founded by Berber fishermen in the 10th century BCE, and was used by the Phoenicians, Romans, and the Merenids as a strategic port called Anfa.
ポルトガル人はそれを壊し、再建してカサ・ブランカと命名しましたが、1755年に発生した地震の後に結局街を捨てて去りました。	The Portuguese destroyed it and rebuilt it under the name Casa Branca, only to abandon it after an earthquake in 1755.
都市はモロッコのスルタンによってダルル・バディアとして再建され、貿易拠点を設立したスペイン人貿易商によってカサブランカと名付けられました。	The Moroccan sultan rebuilt the city as Daru l-Badya and it was given the name Casablanca by Spanish traders who established trading bases there.
カサブランカはモロッコで最も買い物を楽しみにくい場所の1つです。	Casablanca is one of the least interesting places to shop in all of Morocco.
旧メディナ周辺では、タジン、陶器、革製品、フックアなど、モロッコの伝統的な商品を売る場所が簡単に見つかりますが、それらはすべて観光客向けです。	Around the old Medina it's easy to find places selling traditional Moroccan goods, such as tagines, pottery, leather goods, hookahs, and a whole spectrum of geegaws, but it's all for the tourists.
ゴマはコンゴ民主共和国の観光都市でルワンダに近い極東にあります。	Goma is a tourist city of the Democratic Republic of Congo in the extreme east near Rwanda.
2002年にゴマはニラゴンゴ火山の溶岩によって破壊され、ほとんどの街路、特に町の中心部が埋まってしまいました。	In 2002 Goma was destroyed by lava from the Nyiragongo volcano which buried most of the town’s streets, particularly the town centre.
ゴマはかなり安全ですが、ゴマ以外の場所を訪れる場合は、北キブ州で続く戦闘の状況を調査して理解する必要があります。	While Goma is reasonably safe, any visits outside of Goma should be researched to understand the state of the fighting that persists in the North Kivu province.
この都市はニラゴンゴ火山への登山の拠点であり、アフリカで最も安くマウンテンゴリラを追跡できる場所の1つでもあります。	The city is also the base to climb the Nyiragongo volcano along with some of the cheapest Mountain Gorilla tracking in Africa.
ゴマでの移動にはボダボダ（バイクタクシー）を利用することができます。通常の（現地）料金は、短い距離では500コンゴフランほどです。	You can use boda-boda (motorcycle taxi) to get around Goma. The normal (local) price is ~500 Congolese Francs for the short ride.
「ティンブクトゥ」という地名は、簡単には行けない場所であることと相まって、エキゾチックで遠い土地の隠喩として使われるようになりました。	Combined with its relative inaccessibility, "Timbuktu" has come to be used as a metaphor for exotic, distant lands.
現在のティンブクトゥは、その評判から観光地となっており、空港もありますが貧しい町です。	Today, Timbuktu is an impoverished town, although its reputation makes it a tourist attraction, and it has an airport.
砂漠の砂による脅威から保護するため、1990年には危険な世界遺産のリストに追加されました。	In 1990, it was added to the list of world heritage sites in danger, due to the threat of desert sands.
ヘンリー・ルイス・ゲイツ制作のPBS特別番組Wonders of the African World（アフリカ世界の不思議）で主な立ち寄り先の1つでした。	It was one of the major stops during Henry Louis Gates' PBS special Wonders of the African World.
この都市は、アフリカの都市というよりもアラビア色が強く、国内の他の都市とは対照的な雰囲気です。	The city is in stark contrast to the rest of the country's cities, because it has more of an Arabic flair than of an African.
クルーガー国立公園（KNP）は、南アフリカの北東部に位置し、東はモザンビーク、北はジンバブエとの国境に沿って走り、南の国境はクロコダイル川になっています。	The Kruger National Park (KNP) lies in the north-east of South Africa and runs along the border of Mozambique in the east, Zimbabwe in the north, and the southern border is the Crocodile River.
公園の面積は19,500 km2にわたり、14の生態圏に分かれており、各圏に異なる野生生物が生息しています。	The park covers 19,500 km² and is divided in 14 different ecozones, each supporting different wildlife.
ここは南アフリカの主な観光地の1つであり、南アフリカ国立公園（SAN Parks）の目玉とされています。	It is one of the main attractions of South Africa and it is considered the flagship of South African National Parks (SANParks).
南アフリカにあるすべての国立公園と同様に、この公園には毎日保護費と入園料がかかります。	As with all South African National Parks, there are daily conservation and entry fees for the park.
ワイルドカードを購入するとお得な場合があります。南アフリカの主な公園または南アフリカのすべての国立公園に入場できます。	It may also be beneficial for one to buy a Wild Card, which provides entry to either selections of parks in South Africa or all of the South African National Parks.
香港島は、その名のとおり香港の領土であり、観光の目玉として多くの観光客が訪れる場所です。	Hong Kong Island gives the territory of Hong Kong its name and is the place that many tourists regard as the main focus.
香港の地平線を描いて立ち並ぶビル群は、ビクトリア・ハーバーの水の存在によって、きらびやかな棒グラフに例えられています。	The parade of buildings that make the Hong Kong skyline has been likened to a glittering bar chart that is made apparent by the presence of the waters of Victoria Harbour.
香港の最高の景色を見るには、島から出て九龍のウォーターフロントに向かいましょう。	To get the best views of Hong Kong, leave the island and head for the Kowloon waterfront opposite.
香港島の都市開発は、その大半が北岸に沿った干拓地に集中しています。	The great majority of Hong Kong Island's urban development is densely packed on reclaimed land along the northern shore.
ここはイギリスの植民地支配者が自分たちの領土とした場所なので、植民地時代の証拠を探そうとする方は、ここから始めるのが良いでしょう。	This is the place the British colonisers took as their own and so if you are looking for evidence of the territory's colonial past, this is a good place to start.
スンダルバンスは世界最大の沿岸マングローブ地帯であり、海岸からバングラデシュとインドの内陸地域まで80 km（50マイル）にわたって広がっています。	The Sundarbans are the largest littoral mangrove belt in the world, stretching 80 km (50 mi) into the Bangladeshi and Indian hinterland from the coast.
スンダルバン山脈はユネスコの世界遺産に登録されています。インド領内にある森の一部はスンダルバンス国立公園と呼ばれています。	The Sundarbans has been declared a UNESCO World Heritage Site. The part of the forest within Indian territory is called Sundarbans National Park.
この森林はただマングローブが生えているだけの沼地ではありません。森林には、かつてヒンドゥスターン平野を覆っていた広大なジャングルが残っている最後の場所も含まれています。	The forests aren't just mangrove swamps though — they include some of the last remaining stands of the mighty jungles which once covered the Gangetic plain.
スンダルバンスの面積は3,850 km²で、その約3分の1は水域/湿地帯で覆われています。	The Sundarbans cover an area of 3,850 km², of which about one-third is covered in water/marsh areas.
1966年からスンダルバンスは野生動物保護区となり、現在では推定で400頭のロイヤルベンガルトラと約30,000頭のアクシスジカが生息しています。	Since 1966 the Sundarbans have been a wildlife sanctuary, and it is estimated that there are now 400 Royal Bengal tigers and about 30,000 spotted deer in the area.
バスは一日中地区間バスステーション(川を渡って)を出発しますが、ほとんどのバス、特に東に向かうバスとジャカール/ブムタンに向かうものは、午前6時30分から午前7時30分の間に出発します。	Buses depart the inter-district bus station (across the river) throughout the day, though most, especially those heading to the east and Jakar/Bumthang leave between 06:30 and 07:30.
区間バスは満員になることが多いので、数日前までに乗車券を購入しておくことをお勧めします。	As the inter-district buses are often full, it is advisable to purchase a ticket a few days in advance.
ほとんどの地区には日本製のコースターバスが運行し、いずれも快適で頑丈な小型バスです。	Most districts are served by small Japanese Coaster Buses, which are comfortable and sturdy.
パロ（150ニュルタム）やプナカ（200ニュルタム）など、近くの場所への移動には、タクシーを利用するのが便利です。	Shared taxis are a quick and comfortable means to travel to nearby places, such as Paro (Nu 150) and Punakha (Nu 200).
オヤポク川橋は斜張橋です。オヤポク川にかけられたこの橋は、ブラジルのオイヤポックとフランス領ギアナのサン・ジョルジュ・ド・ロイヤポックの都市を結んでいます。	The Oyapock River Bridge is a cable-stayed bridge. It spans the Oyapock River to link the cities of Oiapoque in Brazil and Saint-Georges de l'Oyapock in French Guiana.
2本の塔は高さ83 m、長さ378 mであり、橋には幅3.50 mの2車線があります。	The two towers rise to a height of 83 meters, it's 378 meters long and it has two lanes of 3.50 m wide.
橋下の上方空間は15メートルです。2011年8月に竣工し、2017年3月まで開通しませんでした。	The vertical clearance under the bridge is 15 meters. Construction was completed in August 2011, it didn't open to traffic until March 2017.
橋の全面開通は2017年9月の予定で、ブラジル税関の検問が終わる頃になると予想されています。	The bridge is scheduled to be fully operational in September 2017, when the Brazilian customs checkpoints are expected to be finished.
グアラニー族は、現在のパラグアイ東部に生息する最も重要な先住民族で、半遊牧民の狩猟民族として生活し、自給自足の農業も営んでいました。	The Guaraní were the most significant indigenous group inhabiting what is now Eastern Paraguay, living as semi-nomadic hunters who also practised subsistence agriculture.
チャコ地方には、狩猟、採集、漁業によって生き延びた他の先住民族であるグアイクル族やパヤグア族などの集団が住んでいました。	The Chaco region was home to other groups of indigenous tribes such as the Guaycurú and Payaguá, who survived by hunting, gathering and fishing.
16世紀にスペインの征服者と先住民族との出会いによって（かつて「西インド諸島の巨州」と呼ばれた）パラグアイが誕生しました。	In the 16th century Paraguay, formerly called "The Giant Province of the Indies", was born as a result of the encounter of Spanish conquerors with the native indigenous groups.
スペイン人たちの植民地時代が始まり、それが3世紀続きことになった。	The Spaniards started the colonization period which lasted for three centuries.
1537年にアスンシオンが創設されて以来、パラグアイは土着の特性と独自性を多く残してきました。	Since the foundation of Asunción in 1537, Paraguay has managed to keep a lot of its indigenous character and identity.
アルゼンチンは、世界最高のポロチームとポロ競技選手を擁することで有名です。	Argentina is well known for having one of the best polo teams and players in the world.
今年最大の大会は12月にラスカニタスのポロ競技場で開催されます。	The largest tournament of the year takes place in December at the polo fields in Las Cañitas.
小規模なトーナメントや対抗戦は、他の時期にもここで観戦することができます。	Smaller tournaments and matches can also be seen here at other times of the year.
ポロのトーナメントの日程や試合のチケット購入場所については、Asociacion Argentina de Poloでご確認ください。	For news on tournaments and where to buy tickets for polo matches, check Asociacion Argentina de Polo.
フォークランドの公式通貨はフォークランド諸島ポンド（FKP）で1ポンドが1英ポンド（GBP）と等価に固定されています。	The official Falklands currency is the Falkland pound (FKP) whose value is set equivalent to that of one British pound (GBP).
両替は、スタンレーにある島内唯一の銀行（FIC Westの向かい）でできます。	Money can be exchanged at the only bank in the islands which is located in Stanley across from the FIC West store.
英国ポンドは一般的に島内のどこでも利用でき、スタンレーのクレジットカードや米ドルもよく利用できます。	British pounds will generally be accepted anywhere in the islands and within Stanley credit cards and United States dollars are also often accepted.
離島では、英国と米国の通貨を使えますが、おそらくクレジットカードは使えません。可能な支払い方法を前もって所有者に確認しておきましょう。	On the outlying islands credit cards will probably not be accepted, although British and United States currency may be taken; check with the owners in advance to determine what is an acceptable payment method.
島を出てからフォークランドの通貨を両替することまず不可能なので、島を出る前に両替するようにしましょう。	It is nearly impossible to exchange Falklands currency outside of the islands, so exchange money prior to leaving the islands.
モンテビデオは赤道の南にあるので、北半球が冬になると夏になり、北半球が夏になると冬になるのです。	Since Montevideo is south of the Equator, it is summer there when it's winter in the Northern Hemisphere and vice versa.
モンテビデオは亜熱帯にあり、夏季には30℃を上回る気温が一般的です。	Montevideo is in the subtropics; in the summer months, temperatures above +30°C are common.
気温が氷点下になることはめったにありませんが、風と湿度の関係で温度計が示す気温よりも寒く感じることがあります。	The winter can be deceptively chilly: temperatures rarely go below freezing, but the wind and humidity combine to make it feel colder than what the thermometer says.
「雨季」や「乾季」は特になく、年間を通して雨量はほぼ一定です。	There are no particular "rainy" and "dry" seasons: the amount of rain stays roughly the same throughout the year.
公園内にいる動物の多くは人間を見慣れていますが、それでも野生動物はあくまで野生なので、餌を与えたり、驚かしたりしてはいけません。	Though many of the animals in the park are used to seeing humans, the wildlife is nonetheless wild and should not be fed or disturbed.
公園当局によれば、熊や狼からは最低でも100ヤード（100メートル）、その他の野生動物からは25ヤード（25メートル）の距離を保たなければいけません！	According to park authorities, stay at least 100 yards/meters away from bears and wolves and 25 yards/meters from all other wild animals!
大人しそうに見えても、バイソン、ヘラジカ、アメリカヘラジカ、熊、そしてほぼすべての大型動物は襲ってくることがあります。	No matter how docile they may look, bison, elk, moose, bears, and nearly all large animals can attack.
毎年、適切な距離を保たなかったために、何十人もの旅行客が負傷しています。こうした野生動物は大型で潜在的に危険であるため、縄張りに入らないようにしましょう。	Each year, dozens of visitors are injured because they didn't keep a proper distance. These animals are large, wild, and potentially dangerous, so give them their space.
また、匂いは熊などの野生動物を引き寄せるため、匂いのする食べ物の持ち運びや調理は避け、清潔なキャンプを心がけましょう。	In addition, be aware that odors attract bears and other wildlife, so avoid carrying or cooking odorous foods and keep a clean camp.
アピアはサモアの首都です。この町はウポル島にあり、人口は4万人弱です。	Apia is the capital of Samoa. The town is on the island of Upolu and has a population of just under 40,000.
アピアは1850年代にできた都市で、1959年からサモアの正式な首都になっています。	Apia was founded in the 1850s and has been the official capital of Samoa since 1959.
この港は、1889年にドイツ、アメリカ、イギリスから来た7隻の船が出港を拒否した際に海軍同士が睨み合った有名な場所です。	The harbor was the site of an infamous naval standoff in 1889 when seven ships from Germany, the US, and Britain refused to leave the harbor.
イギリス巡洋艦1隻を除き、全艦船が撃沈されました。この戦いで200人近くのアメリカ人とドイツ人の命が失われました。	All the ships were sunk, except for one British cruiser. Nearly 200 American and German lives were lost.
マウ運動によって組織された独立闘争の間に、町で開かれた平和的な集会で最高責任者トゥプア・タマセーゼ・レアロフィ3世が殺害されました。	During the struggle for independence organised by the Mau movement, a peaceful gathering in the town resulted in the killing of the paramount chief Tupua Tamasese Lealofi III.
オークランドは2つの港に恵まれ、ビーチがたくさんあります。人気のあるビーチは3つのエリアに分かれています。	There are many beaches, due to Auckland's straddling of two harbours. The most popular ones are in three areas.
ノースショアビーチ（ノースハーバー地区）は太平洋に面しており、北はロングベイから南はデボンポートまで続いています。	North Shore beaches (in North Harbour district) are on the Pacific Ocean and stretch from Long Bay in the north to Devonport in the south.
ほとんどが砂浜で安全に泳ぐことができ、ポフツカワの木陰が日除けになります。	They are almost all sandy beaches with safe swimming, and most have shade provided by pohutukawa trees.
タマキ・ドライブ・ビーチは、オークランド中央部の郊外高級地であるミッション・ベイとセント・ヘリエスのワイテマタ港にあります。	Tamaki Drive beaches are on the Waitemata Harbour, in the upmarket suburbs of Mission Bay and St Heliers in Central Auckland.
これらはたまに混雑する家族向けのビーチで、海岸にはさまざまな店舗が並んでいます。安全に泳ぐことができます。	These are sometimes-crowded family beaches with a good range of shops lining the shore. Swimming is safe.
主な地ビールは「ナンバーワン」という名称で、手の込んだビールではないものの、爽やかで飲み心地がスッキリとしたビールです。もう1つの地ビールは「マンタ」という名称です。	The main local beer is 'Number One', it is not a complex beer, but pleasant and refreshing. The other local beer is called "Manta".
フランスワインも手に入りやすいのですが、せっかくの旅ですからニュージーランドやオーストラリアのワインを試してみましょう。	There are many French wines to be had, but the New Zealand and Australian wines might travel better.
現地の水道水は全く問題なく飲めますが、怖いと思ったらボトル入りの水が簡単に手に入ります。	The local tap water is perfectly safe to drink, but bottled water is easy to find if you are fearful.
オーストラリア人にとって「フラットホワイト（ミルクの入り）」コーヒーという概念は外国のものです。ショートブラックは「エスプレッソ」であり、カプチーノは（泡ではなく）クリームがたっぷりと盛られ、紅茶はミルクなしで提供されます。	For Australians, the idea of 'flat white' coffee is foreign. A short black is 'espresso', cappuccino comes heaped high with cream (not froth), and tea is served without milk.
暖かいチョコレートはベルギーの基準を満たす飲み物です。果汁飲料は値が張りますがたいへん美味です。	The hot chocolate is up to Belgian standards. Fruit juices are pricey but excellent.
サンゴ礁への旅行は一年中行われ、サンゴ礁での上記のい原因によるする怪我は稀にしかありません。	Many trips to the reef are made all year around, and injuries due to any of these causes on the reef are rare.
それでも、当局からのアドバイスを受け、すべての標識を守り、安全上の警告に細心の注意を払いましょう。	Still, take advice from authorities, obey all signs, and pay close attention to safety warnings.
ハコクラゲは、10月から4月にかけて1770の北、海岸や河口付近に生息します。この時期以外にも見かけることがあります。	Box jellyfish occur near beaches and near river estuaries from October to April north of 1770. They can occasionally be found outside these times.
鮫はいますが、人間を襲うことはまずありません。ほとんどの鮫は人間を恐れて泳ぎ去ります。	Sharks do exist, however they rarely attack humans. Most sharks are scared of humans and would swim away.
塩水クロコダイルは海を活動の場としているわけではなく、主な生息地はロックハンプトンから北にある川の河口域です。	Saltwater Crocodiles do not actively live in the ocean, their primary habitat is in river estuaries north from Rockhampton.
事前に予約しておけば、旅行者にとって目的地に着いたら寝場所があるという安心感につながります。	Booking in advance gives the traveller peace of mind that they will have somewhere to sleep once they arrive at their destination.
旅行代理店の多くは、特定のホテルと契約していますが、キャンプ場など他の宿泊施設も旅行代理店を通して予約できることがあります。	Travel agents often have deals with specific hotels, although you may find it possible to book other forms of accommodation, like camping grounds, through a travel agent.
通常、旅行代理店は朝食、空港とホテルを結ぶ交通手段の手配、あるいは航空券とホテルを組み合わせたパッケージを提供しています。	Travel agents usually offer packages that include breakfast, transportation arrangements to/from the airport or even combined flight and hotel packages.
また、申し出を考える時間や渡航先に持っていく他の書類（ビザなど）を調達する時間が必要な場合には、予約を保留することもできます。	They can also hold the reservation for you if you need time to think about the offer or procure other documents for your destination (e.g. visa).
しかし、変更願いや要望は、ホテルに直接ではなく、まず旅行代理店に連絡してください。	Any amendments or requests though should be coursed through the travel agent first and not directly with the hotel.
フェスティバルによっては、音楽祭の参加者の大多数が会場内でキャンプをすることが決まっており、ほとんどの参加者はそれがここでの重要な体験の一部であると考えています。	For some festivals, the vast majority of the attendants to music festivals decide to camp on site, and most attendants consider it a vital part of the experience.
実地に体験したければ、早めに到着して演奏が聞こえやすいキャンプ場を確保しなければなりません。	If you want to be close to the action you're going to have to get in early to get a camping site close to the music.
メインステージの音楽が終わっても、フェスティバルには夜遅くまで演奏を流し続けるセクションがあるかもしれないことを覚えておいてください。	Remember that even though music on the main stages may have finished, there may be sections of the festival that will keep playing music until late into the night.
フェスティバルによっては、幼いお子供連れ家族向けに特別なキャンプ場を設けているところもあります。	Some festivals have special camping areas for families with young children.
冬に北バルト海を横断する場合は、船室の位置を確認してください。氷の中を突き進む際に最も影響を受ける船室では恐ろしいほどの騒音が鳴り響きます。	If crossing the Northern Baltic in winter, check the cabin location, as going through ice causes quite horrible noise for those most affected.
サンクトペテルブルクのクルーズには街での滞在時間が含まれています。クルーズの乗客はビザが免除されます（条件を確認してください）。	Saint Petersburg cruises include time in town. Cruise passengers are exempted from visa requirements (check the terms).
カジノでは通常、ゲストに時間とお金を最大限に費やしてもらえるように工夫をこらしています。通常、窓や時計はなく、出口も見つけにくい場合があります。	Casinos typically make many efforts to maximize time and money spent by guests. Windows and clocks are usually absent, and exits can be hard to find.
カジノでは通常、特別な飲食やエンターテイメントを用意しています。ゲストが気分良く施設内に留まるようにするためです。	They usually have special food, drink and entertainment offers, to keep guests in a good mood, and keep them at the premise.
会場によっては、アルコール飲料を提供しています。しかし、酔うと判断力が鈍るので、優れたギャンブラーは誰でもしらふでいることの大切さを知っています。	Some venues offer alcoholic beverages on the house. However, drunkenness impairs judgement, and all good gamblers know the importance of staying sober.
緯度の高い場所や峠を運転する人は、雪や氷、氷点下の可能性を考慮する必要があります。	Anyone who's going to drive at high latitudes or over mountain passes should consider the possibility of snow, ice, or freezing temperatures.
雪道や凍った道は摩擦が少なく、アスファルト道路を走るような運転はできません。	On icy and snowy roadways, friction is low and you cannot drive as if you were on bare asphalt.
吹雪になると、ほんの短時間に足止めに十分な雪が降り積もります。	During blizzards, enough snow to get you stuck can fall in very little time.
また、雪が降ったり吹きつけたり、車窓が結露や氷で覆われて視界が制限されることもあります。	Visibility may also be restricted by falling or blowing snow or by condensation or ice on vehicle windows.
一方、多くの国では氷雪の多い状況が普通ですが、交通は1年中ほぼ途切れることなく続いています。	On the other hand, icy and snowy conditions are normal in many countries, and traffic goes on mostly uninterrupted all year round.
サファリはおそらくアフリカで最高の観光名所であり、多くの観光客にとって観光の目玉です。	Safaris are perhaps the greatest tourism draw in Africa and the highlight for many visitors.
サファリとは、アフリカの野生動物、特にサバンナにいる野生動物の観察を目的とした陸路での旅行を指します。	The term safari in popular use refers to overland travel to view the stunning African wildlife, particularly on savanna.
象やキリンなど、一部の動物は車に近寄ってくる傾向があるので、標準的な機器を利用すればはっきりと観察できます。	Some animals, such as elephants and giraffes, tend to approach closely to cars and standard equipment will allow good viewing.
ライオン、チーター、ヒョウは意外に憶病なので、よく見えるように双眼鏡を使うことになります。	Lions, cheetahs and leopards are sometimes shy and you will see them better with binoculars.
ウォーキングサファリ（別名は「ブッシュウォーク」、「ハイキングサファリ」、「徒歩見学」）は、数時間から数日間かけてサファリゾーンを歩いて回る企画です。	A walking safari (also called a "bush walk", "hiking safari", or going "footing") consists of hiking, either for a few hours or several days.
パラリンピックの開催期間は2021年8月24日から9月5日までの予定です。日本全国の各地で催される競技もあります。	The Paralympics will take place from 24 August to 5 September 2021. Some events will be held in other locations throughout Japan.
東京は、1964年の開催以来、夏季オリンピックを2回開催したアジアで唯一の都市となります。	Tokyo will be the only Asian city to have hosted two summer Olympics, having hosted the games in 1964.
延期が発表される前に2020年の航空券や宿泊施設を予約していた方は、面倒な状況に陥る可能性があります。	If you booked your flights and accommodation for 2020 before the postponement was announced, you may have a tricky situation.
キャンセルポリシーはさまざまですが、3月下旬の時点で、ほとんどのコロナウイルス関連のキャンセルポリシーは、オリンピックが予定されていた2020年7月まで延長されません。	Cancellation policies vary, but as of late March most coronavirus-based cancellation policies don't extend to July 2020, when the Olympics had been scheduled.
イベントチケットは2,500円～13万円の価格帯で、通常のチケットは約7,000円になると予想されています。	It's expected that most event tickets will cost between ¥2,500 and ¥130,000, with typical tickets costing around ¥7,000.
湿った衣類にはアイロンをかけると乾きやすくなります。多くのホテルでは、部屋にアイロンとアイロン台がなくても頼めば貸し出してくれます。	Ironing damp clothes can help them dry. Many hotels have an iron and ironing board available for loan, even if one is not present in the room.
アイロンがない場合やアイロンをかけずに乾かしたい靴下などの場合、ドライヤーがあればそれを使ってみるのもいいでしょう。	If an iron isn't available, or if you don't fancy wearing ironed socks, then you can try using a hairdryer, if available.
生地の温度が上がりすぎないように気を付けてください（縮みの原因になったり、極端な場合は焦げ付きの原因になります）。	Be careful not to allow fabric to become too hot (which can cause shrinkage, or in extreme cases, scorch).
浄水処理には各種の方法があります、飲水の水質に脅威となる特定のリスクに対して効果のある高度な処理方法もあります。	There are different ways of purifying water, some more effective against specific threats.
1分間で沸騰する地域もあれば、沸騰するまでに何分もかかる地域もあります。	In some areas boiling water for a minute is enough, in others several minutes are needed.
フィルターの効果には差がありますが、気になる場合は、信頼できる会社から密閉ボトル入りの水を購入することを検討してみてください。	Filters vary in effectiveness, and should you have a concern, then you should consider buying your water in a sealed bottle from a reputable company.
旅行客は、自分の居住地では馴染みのない病害動物に遭遇することがあります。	Travellers may encounter animal pests that they are not familiar with in their home regions.
害虫は食物を台無しにしたり、皮膚を刺したり、最悪の場合はアレルギー反応の原因になったり、毒を撒き散らしたり、感染症を媒介することがあります。	Pests can spoil food, cause irritation, or in a worse case cause allergic reactions, spread venom, or transmit infections.
感染症自体や、力ずくで人を殺傷する危険動物は、通常は有害生物には該当しません。	Infectious diseases themselves, or dangerous animals that can injure or kill people by force, do not usually qualify as pests.
ポイントマリオンとフェアモントの間の区間は、バッファローとピッツバーグを結ぶ幹線道路のうち最も運転しなくい区間で、隔絶した未開の森林地帯を頻繁に通過します。	The stretch between Point Marion and Fairmont presents the most challenging driving conditions on the Buffalo-Pittsburgh Highway, passing frequently through isolated backwoods terrain.
田舎道の運転に慣れていない方は、急勾配、狭い車線、急カーブに注意し、気を抜かないでください。	If you're not used to driving on country roads, keep your wits about you: steep grades, narrow lanes, and sharp curves predominate.
提示されている制限速度は前後の区間に比べて明らかに低く、一般的には時速35～40マイル（56～64キロ）とされ、その制限速度に厳密に従うことが他の区間よりも重要とされます。	Posted speed limits are noticeably lower than in previous and subsequent sections — commonly 35-40 mph (56-64 km/h) — and strict obedience to them is even more important than otherwise.
しかし、不思議なことに、ここでは他の多くの地区（ペンシルバニア・ワイルズなど）に比べて、携帯電話のサービスが充実しています。	Curiously, though, mobile phone service is much stronger here than along many other stretches of the route, e.g. the Pennsylvania Wilds.
ヨーロッパは比較的小さな大陸ですが、独立国が多数あります。通常の状況では、複数の国を旅行しようとすると、ビザの申請や入国審査がに何度も必要になります。	Europe is a continent that is relatively small but with many independent countries. Under normal circumstances, travelling through multiple countries would mean having to go through visa applications and passport control multiple times.
しかし、シェンゲン圏は、この点では一国のように機能します。	The Schengen zone, however, works somewhat like one country in this respect.
この圏内に留まっている限り、通常は出国審査を何度も受けることなく国境を越えることができます。	As long as you stay in this zone, you can generally cross borders without going through passport control checkpoints again.
同じように、シェンゲンビザさえ取得すれば、シェンゲン加盟国のビザを個別に申請する必要がなくなり、時間、費用、事務処理の手間が相当に省けます。	Similarly, by having a Schengen visa, you do not need to apply for visas to each of the Schengen member countries separately, hence saving time, money and paperwork.
骨董品について普遍的な定義はありません。税務署によっては、100年以上前のものを骨董品と定義しています。	There is no universal definition for which manufactured items are antiques. Some tax agencies define goods older than 100 years as antiques.
この定義には地理的な変動があり、北米などでは欧州よりも年齢制限の範囲が狭まる可能性があります。	The definition has geographic variations, where the age limit might be shorter in places such as North America than in Europe.
手工芸品は、大量生産された類似品よりも歴史は浅いのですが、骨董品と定義されることもあります。	Handicraft products might be defined as antiques, though they are younger than similar mass-produced goods.
トナカイの飼育はサーミ族の重要な生計手段であり、その取引を取り巻く文化は他の職業を生業とする多くの人々にとっても重要なものです。	Reindeer husbandry is an important livelihood among the Sámi and the culture surrounding the trade is important also for many with other professions.
しかし、サーミ人は伝統的に、大規模なトナカイの飼育に携わってきたわけではなく、漁や狩猟などの生活を営んできたため、トナカイはほとんどが使役動物として飼われていました。	Even traditionally, though, not all Sámi have been involved in big scale reindeer husbandry, but lived from fishing, hunting and similar, having reindeer mostly as draft animals.
今日では多くのサーミ人が近代的な貿易に従事しています。観光はサーミ地方の重要な収入源です。	Today many Sámi work in modern trades. Tourism is an important income in Sápmi, the Sámi area.
「ジプシー」という言葉は、特にロマ人以外の人たちの間で広く使われていますが、否定的な固定観念やロマ人に対する不正確な認識と結びついているため、往々にして不快な言葉とみなされます。	Though it is widely used, especially among non-Romani, the word "Gypsy" is often considered offensive because of its associations with negative stereotypes and inaccurate perceptions of Romani people.
訪れようとする国が旅行勧告の対象となった場合、旅行健康保険や旅行キャンセル保険に影響する可能性があります。	If the country you will be visiting becomes subject to a travel advisory, your travel health insurance or your trip cancellation insurance may be affected.
自国以外の政府からの助言を参考にしてもかいまいませんが、そのような助言はその国の国民向けのものです。	You may also wish to consult the advice of governments other than your own, but their advice is designed for their citizens.
例として、中東に暮らすアメリカ人は、ヨーロッパ人やアラブ人とは異なる状況に直面する可能性があります。	As one example, American citizens in the Middle East might face different situations from Europeans or Arabs.
勧告は、ある国における安全保障状況の要約にすぎません。	Advisories are merely a brief summary of the political situation in one country.
提示された見解は、他の場所で入手可能なより詳細な情報に比べて、大雑把で単純化されすぎた上っ面だけのものが多い。	The views presented are often cursory, general and oversimplified compared to the more detailed information available elsewhere.
悪天候とは、物理的被害、深刻な社会的混乱、人命に関わる被害につながりうる危険な気象現象の総称です。	Severe weather is the generic term for any dangerous weather phenomenon with the potential to cause damage, serious social disruption, or loss of human life.
厳しい天候は世界のどこでも見られ、その種類は地理、地形、大気の状態によって異なります。	Severe weather can occur anywhere in the world, and there are different types of it, which can depend on geography, topography, and atmospheric conditions.
強風、ひょう、過度の降水量、および山火事は、雷雨、竜巻、水噴き、およびサイクロンなどの厳しい気象形態やその影響によるものです。	High winds, hail, excessive precipitation, and wildfires are forms and effects of severe weather, as are thunderstorms, tornadoes, waterspouts, and cyclones.
地域的・季節的な厳しい気象現象としては、吹雪、吹雪、暴氷、砂嵐などがあります。	Regional and seasonal severe weather phenomena include blizzards, snowstorms, ice storms, and dust storms.
旅行計画に影響を及ぼすことがあるので、旅行者の方々には、旅先の地域に影響を及ぼしうる悪天候のリスクを認識することを強くお勧めします。	Travellers are strongly advised to be aware of any risk of severe weather affecting their area as they may affect any travel plans.
紛争地域と見なされうる国への渡航を計画している人は全員が専門的な研修を受ける必要があります。	Anyone planning a visit to a country that could be considered a war zone should get professional training.
インターネットで「敵対的環境コース」について検索すると、おそらく現地企業の住所が出てくるでしょう。	A search of the Internet for 'Hostile environment course' will probably provide the address of a local company.
コースは一般に、ここで説明しているあらゆる問題についてはるかに詳細事項まで扱い、通常は実践的な演習もあります。	A course will normally cover all the issues discussed here in far greater detail, usually with practical experience.
コースは通常2～5日間で、ロールプレイや応急手当て、ときには武器の使い方を訓練することもあります。	A course will normally be from 2-5 days and will involve role play, a lot of first aid and sometimes weapons training.
荒野でのサバイバルを扱った本や雑誌は珍しくありませんが、紛争地域を扱った出版物はごくわずかです。	Books and magazines dealing with wilderness survival are common, but publications dealing with war zones are few.
海外での性転換手術を受ける予定の旅行者は、帰国時に身分証明できる有効な書類を確実に携帯する必要があります。	Voyagers planning sex reassignment surgery abroad must ensure they're carrying valid documents for the return trip.
性別の記載がないパスポート（性別欄「X」）を発行したり、本人の希望に応じた名前や性別に更新した書類を発行する政府の意思はさまざまです。	The willingness of governments to issue passports with gender not stated (X) or documents updated to match a desired name and gender varies.
外国政府がこれらの書類を認めようとする意志も、同様に非常に多様です。	Willingness of foreign governments to honour these documents is just as widely variable.
2001年9月11日以降の時代になると、セキュリティチェックポイントでの検査もさらに干渉型になりました。	Searches at security checkpoints have also become far more intrusive in the post-September 11, 2001 era.
手術前の性転換者たちは、プライバシーと尊厳を保ったままスキャナーを通過できると思ったら間違いです。	Pre-operative transgender people should not expect to pass through the scanners with their privacy and dignity intact.
離岸流とは、砕けて浜辺に戻ってくる引き波のことで、多くの場合、岩礁やそれに似た場所で発生します。	Rip currents are the returning flow from waves breaking off the beach, often at a reef or similar.
海底地形により、戻り波は少数の深い部分に集中しており、深海へ向かう速い流れがそこに形成される場ことがあります。	Due to the underwater topology the return flow is concentrated at a few deeper sections, and a fast current to deep water may form there.
ほとんどの死因は、流れに逆らって泳ごうとする疲労によるものですが、流れに逆らって泳ぐことはおそらく不可能です。	Most deaths happen as result of fatigue trying to swim back against the current, which may be impossible.
流れから抜け出れば、泳いで戻るのはそれほど難しくありません。	As soon as you get out of the current, swimming back is no more difficult than normally.
二度と波に捕まらない場所を狙ってみるか、泳力に自信がないという自覚があれば、救助を待った方がいいかもしれません。	Try aiming somewhere where you are not caught again or, depending on your skills and on whether you have been noticed, you might want to wait for rescue.
再入国ショックは（新婚旅行の時期が少ない）カルチャーショックよりも早く訪れ、長引き、より症状が悪化することがあります。	Re-entry shock comes on sooner than culture shock (there's less of a honeymoon phase), lasts longer, and can be more severe.
新しい文化に易々と馴染めた旅行者も、現地固有の文化に馴染むのには苦労することがあります。	Travellers who had an easy time adjusting to the new culture sometimes have a particularly hard time readjusting to their native culture.
海外で暮らしてから帰国すると、新しい文化に順応した分だけ母国文化の習慣のを失っているものです。	When returning home after living abroad, you've adapted to the new culture and lost some of your habits from your home culture.
初めての海外旅行なら、おそらく周囲の人たちは辛抱強く、理解しようとする気持ちで対応してくれるでしょう。旅行者に慣れが必要だと知っているからです。	When you went abroad at first, people were probably patient and understanding, knowing that travellers in a new country need to adapt.
旅行者は帰国に際しても忍耐と理解を要することを人々は予想していないかもしれません。	People may not anticipate that patience and understanding are also necessary for travellers returning home.
ピラミッドの音と光のショーは、この観光地で特に子供たちが楽しめる催しの1つです。	The pyramid sound and light show is one of the most interesting things in the area for kids.
暗闇の中にピラミッドが見え、開演前には沈黙の中でピラミッドを見学できます。	You can see the pyramids in the dark and you can see them in silence before the show begins.
通常、ここではいつも観光客や業者たちが発する音が聞こえてきます。音と光が織りなす物語はまるで絵本のようです。	Usually you always here the sound of tourists and vendors. The story of the sound and light is just like a story book.
スフィンクスは長い物語の背景であるとともに語り手でもあります。	The Sphinx is set as the backdrop and the narrator of a long story.
夜空の下でピラミッドに映像が浮かび、ピラミッドが次々とライトアップされます。	The scenes are displayed on the pyramids and the different pyramids are lit up.
飛行機の旅は、あらゆる年齢層や経歴の人々にとって恐ろしい経験になる可能性があり、特に飛行機に乗ったことがなかったり、トラウマになるような出来事を経験したことのある人の場合にはその傾向があります。	Travelling by plane can be a scary experience for people of all ages and backgrounds, particularly if they've not flown before or have experienced a traumatic event.
それは恥ずべきことではなく、非常に多くの人が持っている個人的な恐怖心や嫌悪感と何ら変わりません。	It is not something to be ashamed of: it is no different from the personal fears and dislikes of other things that very many people have.
飛行機の仕組みや飛行中の挙動を理解することで、未知のものや自分がコントロールできないことへの恐怖心を克服できることがあります。	For some, understanding something about how aircraft work and what happens during a flight may help to overcome a fear which is based on the unknown or on not being in control.
宅配業者は、急ぎの配達で高報酬を得ています。多くの場合、業務書類、商品、または緊急の修理に必要な交換部品などは短時間で届くことが重要です。	Courier companies are well paid for delivering things quickly. Frequently, time is very important with business documents, merchandise or spare parts for an urgent repair.
一部の路線では大企業は自社機を持っているが、それ以外の路線や小規模企業では問題があった。	On some routes, the larger companies have their own planes, but for other routes and smaller firms there was a problem.
航空貨物で荷物を送った場合、空路によって荷降ろしや税関を通過するのに何日もかかってしまうこともありました。	If they sent things by air freight, on some routes it may have taken days to get through unloading and customs.
早く通過させるためには、預け荷物として送るしかありませんでした。航空会社の規定では乗客がいない場合、荷物を送ることができないので、その後が肝心です。	The only way to get it through faster was to send it as checked luggage. Airline regulations will not allow them to send luggage without a passenger, which is where you come in.
ファーストクラスやビジネスクラスに乗るには、当然ながら待遇の分だけ高額を支払うことになります（出張であれば勤め先の会社に交渉してみてください）。	The obvious way of flying in first or business class is to fork out a thick wad of money for the privilege (or, better yet, get your company to do it for you).
しかし、決して安くはありません。通常のエコノミークラスで支払う料金に比べて、ビジネスクラスは4倍、ファーストクラスは11倍というのが大まかな目安です。	However, this does not come cheap: as rough rules of thumb, you can expect to pay up to four times the normal economy fare for business, and eleven times for first class!
一般的に言えば、AからBへの直行便のビジネスクラスやファーストクラスの座席の割引を探しても意味がありません。	Generally speaking, there is no point in even looking for discounts for business or first-class seats on direct flights from A to B.
航空会社は、目的地まで速く快適に移動できるという特権のために最高額を支払ってもかまわないと思っている特定の乗客の中心的グループが存在することを心得ているため、そうした料金を請求しているのです。	Airlines know well that there is a certain core group of flyers who are willing to pay top dollar for the privilege of getting somewhere fast and in comfort, and charge accordingly.
モルドバの首都はチインウです。現地語はルーマニア語ですが、ロシア語が広く使われています。	The capital of Moldova is Chişinău. The local language is Romanian, but Russian is widely used.
モルドバは多民族国家であり、民族紛争に悩まされてきました。	Moldova is a multi-ethnic republic that has suffered from ethnic conflict.
この紛争により、1994年にモルドバ東部のトランスニストリア共和国が誕生し、共和国には独自政府と通貨がありますが、どの国連加盟国にも認められていません。	In 1994, this conflict led to the creation of the self-proclaimed Transnistria Republic in eastern Moldova, which has its own government and currency but is not recognised by any UN member country.
政治交渉が失敗したにもかかわらず、モルドバのこの2つの地域の間には経済的なつながりが再び確立されています。	Economic links have been re-established between these two parts of Moldova despite the failure in political negotiations.
モルドバの主な宗教は正統派キリスト教です。	The major religion in Moldova is Orthodox Christian.
エーゲ海に面したイズミルは、人口は約370万人を擁するトルコで3番目の大都市です。イスタンブールに次ぐ第2の港があり、交通の要所でもあります。	İzmir is the third largest city in Turkey with a population of around 3.7 million, the second biggest port after Istanbul, and a very good transport hub.
かつてはスミルナの古代都市でしたが、今では巨大な湾を中心に山に囲まれた、近代的に開発された賑やかな商業中心地となっています。	Once the ancient city of Smyrna, it is now a modern, developed, and busy commercial center, set around a huge bay and surrounded by mountains.
広い大通りやガラス張りの建物、近代的なショッピングセンターには、伝統的な赤瓦屋根の建物や18世紀の市場、古いモスクや教会、シナゴーグなどが点在しており、伝統的なトルコというよりも地中海ヨーロッパの雰囲気が漂っています。	The broad boulevards, glass-fronted buildings and modern shopping centers are dotted with traditional red-tiled roofs, the 18th century market, and old mosques and churches, although the city has an atmosphere more of Mediterranean Europe than traditional Turkey.
ハルダルシクの村からは、近くのエストゥロイ島が見え、村には珍しい八角形の教会があります。	The village of Haldarsvík offer views of the nearby island Eysturoy and has an unusual octagonal church.
教会の墓地では、興味深い大理石製の鳩の彫刻が一部の墓に飾られています。	In the churchyard, there are interesting marble sculptures of doves over some tombs.
興味をそそられる村を30分ほど散策するのは価値があります。	It's worth half an hour to stroll about the intriguing village.
北部にはロマンチックで魅力的なシントラの町があり、この町はバイロン卿がその素晴らしさを熱く語ったことで外国人にも有名になりました。	To the north and within easy reach is the romantic and fascinating town of Sintra and which was made famous to foreigners after a glowing account of its splendours recorded by Lord Byron.
シントラ行きのスコッターブバス403が定期的に運行しており、カボ・ダ・ロカに停車します。	Scotturb Bus 403 travels regularly to Sintra, stopping at Cabo da Roca.
また、北側に行くなら世界的に有名なマリア像の聖地であるファティマの聖母の聖域（神社）を訪れましょう。	Also to the north visit the great Sanctuary of Our Lady of Fatima (Shrine), a place of worldwide famous Marian apparitions.
自分が訪れたのは本質的に巨大な集団墓地であり、世界の人口の大多数にとって計り知れないほどの意味を持つ墓地であることをお忘れにならないでください。	Please remember that you are essentially visiting a mass grave site, as well as a site that has an almost incalculable meaning to a significant portion of the world's population.
ここには当時を生き延びた多くの男女がおり、ユダヤ人かどうかを問わず、そこで大切な人が殺害されたり強制労働させられたりした人たちも大勢います。	There are still many men and women alive who survived their time here, and many more who had loved ones who were murdered or worked to death there, Jews and non-Jews alike.
場にふさわしい敬意を払い、尊厳と礼節をもって立ち振る舞ってください。ホロコーストやナチスについて冗談を言うなどもってのほかです。	Please treat the site with all of the dignity, solemnity and respect it deserves. Do not make jokes about the Holocaust or Nazis.
建造物に塗料や刃物で落書きするような名所を汚す行為を慎みましょう。	Do not deface the site by marking or scratching graffiti into structures.
バルセロナの公用語はカタルーニャ語とスペイン語です。約半数がカタルーニャ語を好み、大多数がカタルーニャ語を理解し、ほぼ全員がスペイン語を知っています。	Barcelona's official languages are Catalan and Spanish. About a half prefer to speak Catalan, a vast majority understands it, and virtually everyone knows Spanish.
しかし、カタルーニャ語が第一公用語として法律で定められているため、ほとんどの標識がカタルーニャ語のみで表示されています。	However, most signs are indicated only in Catalan because it is established by law as the first official language.
とはいえ、公共交通機関などでもスペイン語は広く使われています。	Yet, Spanish is also widely used in public transport and other facilities.
メトロの構内や車内の定期アナウンスはカタルーニャ語のみですが、事故による遅延などの際には自動システムによってスペイン語、英語、フランス語、アラビア語、日本語といった各言語でアナウンスされます。	Regular announcements in the Metro are made only in Catalan, but unplanned disruptions are announced by an automated system in a wide variety of languages including Spanish, English, French, Arabic and Japanese.
パリジャンは、自己中心的で横柄で失礼な人が多いと言われています。	Parisians have a reputation for being egocentric, rude and arrogant.
これは不正確な固定観念にすぎませんが、パリうまくやっていくための最善の方法は、「育ちの良い」人らいく振る舞って最善の行動をとることです。そうすれば、快適に過ごせるようになるでしょう。	While this is often only an inaccurate stereotype, the best way to get along in Paris still is to be on your best behavior, acting like someone who is "bien élevé" (well brought up). It will make getting about considerably easier.
一見とっつきにくいパリジャンですが、こちらが基本的な礼儀作法を示せばすぐに変わるでしょう。	Parisians' abrupt exteriors will rapidly evaporate if you display some basic courtesies.
プリトヴィッツェ湖群国立公園は、アルプスと地中海の植生が混在する広大な森（主にブナ、トウヒ、モミ）に大小16の湖が点在し、絶景で溢れる世界遺産です。	The Plitvice Lakes national park is heavily forested, mainly with beech, spruce, and fir trees, and features a mixture of Alpine and Mediterranean vegetation.
微気候のため、土壌や標高の範囲が極めて広いので、植物群落の種類が非常に豊富です。	It has a notably wide variety of plant communities, due to its range of microclimates, differing soils and varying levels of altitude.
また、この地域には多種多様な動物や鳥類が生息しています。	The area is also home to an extremely wide variety of animal and bird species.
ヨーロッパのヒグマ、オオカミ、ワシ、フクロウ、オオヤマネコ、ヤマネコ、カペルカイリーなどの希少種が見られ、より多くの普通種がともに生息しています。	Rare fauna such as the European brown bear, wolf, eagle, owl, lynx, wild cat and capercaillie can be found there, along with many more common species
修道院を訪れる際には、女性は膝を覆うスカートを履き、肩も覆われていることが義務付けられています。	While visiting the monasteries, women are required to wear skirts covering the knees and have their shoulders covered, too.
ほとんどの修道院では、準備なしで来た女性のために覆いを用意していますが、自前で特に明るい色のものを持参すると、入口で僧侶や尼僧から微笑んでもらえるでしょう。	Most of the monasteries do provide wraps for women who come unprepared, but if you bring your own, especially one with bright colors, you'll get a smile from the monk or nun at the entrance.
同じように、男性は膝を覆うズボンを履くことが義務付けられています。	Along the same line, men are required to wear trousers covering the knees.
これも入口にある受付で借してもらえますが、利用者ごとに洗濯しているわけではないことを考えると、履くのに抵抗がある人もいるかもしれません。男性用のワンサイズです。	This too can be borrowed from the stock at the entrance but that clothing isn't washed after every user so you may not feel comfortable wearing these skirts. One size fits all for men!
マヨルカ島の料理は、地中海の他の地域と同様に、パン、野菜、肉（特に豚肉）を主な食材とし、オリーブオイルを多用します。	Majorcan cuisine, like that of similar zones in the Mediterranean, is based on bread, vegetables and meat (specially pork), and uses olive oil throughout.
特に夏場には、オリーブオイルを塗ったパンにトマトとチーズ、チューナなどの調味料を加えた「パンボリ」というシンプルな料理が人気です。	A simple popular dinner, especially during the summer, is the Pa amb Oli: Bread with olive oil, tomato, and any available condiments such as cheese, tunafish, etc.
