ماي سبيس هو ثالث أكثر المواقع الإلكترونيّة رواجاً في الولايات المتّحدة، وبه 54 مليون حساب حالياً.	MySpace is the third most popular website used in the United States and has 54 million profiles currently.
لقد حظيت هذه المواقع الإلكترونية باهتمامٍ كبير، خاصةً في البيئة التعليمية.	These websites have gotten a lot of attention, especially in the education setting.
ويوجد جوانب إيجابية لهذه المواقع، ومن ضمنها، القدرة على عداد صفحة الصف التدريبي بشكل سهل والتي يمكن أن تضم المدونات ومقاطع الفيديو والصور ومميزاتٍ أخرى.	There are positive aspects to these websites, which include, being able to easily setup a class page which can include blogs, videos, photos, and other features.
يمكن الوصول إلى هذه الصفحة بسهولة من خلال توفير عنوان ويب واحد فقط، مما يجعل من السهل تذكره وكتابته للطلاب الذين قد يواجهون مشكلة في استخدام لوحة المفاتيح أو في التهجئة.	This page can easily be accessed by providing just one web address, which makes it easy to remember and easy to type in for students who may have trouble using the keyboard or with spelling.
يمكن تخصيصها لجعل القراءة أسهل وكذلك مع أكبر قدر من الألوان أو أقل حسب الحاجة.	It can be customized to make it easy to read and also with as much or little color as desired.
اضطراب نقص الانتباه "متلازمة عصبية يمكن تشخيصها عن طريق ثلاثة أعراض معتادة هي الاندفاع، وسهولة التشتت، وفرط النشاط أو الطاقة الزائدة".	Attention Deficit Disorder "is a neurological syndrome whose classic defining triad of symptoms including impulsivity, distractibility, and hyperactivity or excess energy".
ليست إعاقةً في التعلم لكنه اضطرابٌ في التعلم؛ " يستهدف ما بين 3 إلى 5 بالمائة من كل الأطفال، أي ما يعادل 2 مليون من الأطفال الأمريكيين."	It is not a learning disability, it is a learning disorder; it "affects 3 to 5 percent of all children, perhaps as many as 2 million American children".
إن الأطفال المصابين باضطراب نقص الانتباه يواجهون صعوبةً في التركيز على أشياءٍ مثل الواجبات المدرسية، لكن يمكنهم التركيز على الأشياء التي يستمتعون القيام بها مثل اللعب أو مشاهدة الرسوم المتحركة المفضلة لديهم أو كتابة الجمل من دون علامات ترقيم.	Children with ADD have a hard time focusing on things like school work, but they can concentrate on things they enjoy doing like playing games or watching their favorite cartoons or writing sentences without punctuation.
يميل هؤلاء الأطفال إلى الوقوع في الكثير من المشاكل، لأنهم "ينخرطون في سلوكيات محفوفة بالمخاطر، ويتشاجرون، ويتحدون السلطة" لتحفيز عقولهم، حيث لا يمكن تحفيز أدمغتهم بالطرق العادية.	These children tend to get into a lot of trouble, because they "engage in risky behaviors, get into fights, and challenge authority" in order to stimulate their brain, since their brain can not be stimulated by normal methods.
يؤثر اضطراب نقص الانتباه على العلاقات مع الأقران لأن الأطفال الآخرين لا يمكنهم فهم سبب تصرفاتهم أو تكلمهم بطريقة معينة أو أن مستوى نضجهم مختلف.	ADD affects relationships with other peers because other children can not understand why they act the way that they do or why they spell they way they do or that their maturity level is different.
وطالب المستعمرون، الذين شاهدوا هذا النشاط، بتعزيزات.	The Colonists, seeing this activity, had also called for reinforcements.
ضمّت تعزيزات المواقع الأمامية كتيبتي نيوهامبشير الأولى والثالثة في صفوفهما 200 من الرجال يقودهم العقيد چون ستارك والعقيد چيمس ريد (والذين أصبحا بعدها جنرالين).	Troops reinforcing the forward positions included the 1st and 3rd New Hampshire regiments of 200 men, under Colonels John Stark and James Reed (both later became generals).
تمركز رجال ستارك في مواقع بطول السياج من الطرف الشمالي لمكان المستعمر.	Stark's men took positions along the fence on the north end of the Colonist's position.
عندما فتح المدّ المنخفض فجوة على طول النهر الغامض على طول الجانب الشمالي الشرقي من شبه الجزيرة، مدّوا السياج سريعاً بجدار حجري قصير إلى الشمال ينتهي عند حافة المياه على شاطئ صغير.	When low tide opened a gap along the Mystic River along the northeast of the peninsula, they quickly extended the fence with a short stone wall to the north ending at the water's edge on a small beach.
وضع جريدلي أو ستارك وتدًا على بعد حوالي 100 قدم (30 مترًا) أمام السياج وأمر ألا يطلق أحد النار حتى يعبره ضباط الجيش.	Gridley or Stark placed a stake about 100 feet (30 m) in front of the fence and ordered that no one fire until the regulars passed it.
اعتمدت الخطة الأمريكية على شن هجمات منظمة من ثلاثة اتجاهات مختلفة.	The American plan relied on launching coordinated attacks from three different directions.
يمكن للجنرال جون كادوالادر شن هجوم لتشتيت الانتباه ضد الحامية البريطانية في بوردينتاون لمنع أي تعزيزات.	General John Cadwalder would launch a diversionary attack against the British garrison at Bordentown, in order to block off any reinforcements.
سيأخذ الجنرال جيمس أوينج 700 من عناصر المليشيا عبر النهر في عبارة ترينتون، ويستولي على الجسر فوق خليج أسونبينك، وسيمنع أي قوات معادية من الهروب.	General James Ewing would take 700 militia across the river at Trenton Ferry, seize the bridge over the Assunpink Creek and prevent any enemy troops from escaping.
كانت قوّة الهجوم الرئيسيّة، المكوّنة من 2,400 رجلاً، ستعبر النهر الواقع على بعد تسعة أميال شمال ترينتون، ثم تنقسم إلى مجموعتين، الأولى بقيادة غرين والثانية بقيادة سوليفان، من أجل إطلاق هجوم قبل الفجر.	The main assault force of 2,400 men would cross the river nine miles north of Trenton, and then split into two groups, one under Greene and one under Sullivan, in order to launch a pre-dawn attack.
بينما يجب أن يجعل التعلم القائم على المشروع عملية التعلم أسهل وأكثر إثارة للاهتمام، فإن المساندة تتجاوز ذلك.	While project based learning should make learning easier and more interesting, scaffolding goes a step beyond.
التعلم التفاعلي ليس طريقة للتعلم ولكنها بالأحرى وسيلة مساعدة تقدم الدعم للأفراد الذين يمرون بتجربة تعليمية جديدة مثل استخدام برنامج كمبيوتر جديد أو بدء مشروع جديد.	Scaffolding is not a method of learning but rather an aid that provides support to individuals whom are undergoing a new learning experience such as using a new computer program or beginning a new project.
يمكن أن يكون التعلم التفاعلي افتراضياً وعلى أرض الواقع، وبصياغةٍ أخرى، المعلم هو شكل من أشكال التعلم التفاعلي، وكذلك رجل مشبك الورق في مايكروسوفت أوفيس.	Scaffolds can be both virtual and real, in other words, a teacher is a form of scaffold but so is the little paperclip man in Microsoft Office.
يتمُّ دعْم التعلُّم التفاعليّ في البرنامج داخليًا ويهدف إلى طرح الأسئلة والتحفيز وشرح الإجراءاتِ التي قد يكون من الصعب على الطالب التعامل معها بمفرده.	Virtual Scaffolds are internalized in the software and are meant to question, prompt, and explain procedures that may have been to challenging for the student to handle alone.
ويوضع الأطفال في إطار الرعاية الحاضنة لأسباب متنوعة تتراوح بين الإهمال والإيذاء وحتى الابتزاز.	Children are placed in Foster Care for a wide variety of reasons that range from neglect, to abuse, and even to extortion.
لا ينبغي لأي طفل أبداً أن ينمو في بيئة لا تقوم على التنشئة والرعاية والتعليم، ولكنهم يفعلون ذلك.	No child should ever have to grow up in an environment that is not nurturing, caring, and educational, but they do.
ندرك أن نظام الرعاية البديلة يعد منطقة الأمان لهؤلاء الأطفال.	We perceive the Foster Care System to be a safety zone for these children.
يُفترض نظامنا للرعاية بالتبني أن يوفر منازل آمنة، ومقدمي رعاية محبين، وتعليمًا مستقرًا، ورعاية صحية يمكن الاعتماد عليها.	Our foster care system is supposed to provide safe homes, loving caregivers, stable education, and reliable health care.
يجب على الرعاية البديلة توفير كل الضروريّات التي افتقدوها في البيوت التي خرجوا منها سابقاً.	Foster care is supposed to provide all the necessities that were lacking in the home they were previously taken from.
بعد تبنيه من قبل الكونغرس في 4 يوليو، أُرسلت مسودةٌ مكتوبةٌ بخط اليد وقعها رئيس الكونغرس جون هانكوك وأمين السر تشارلز طومسون على بعد البعض من الأبنية إلى مطبعة جون دونلاب.	After its adoption by Congress on July 4, a handwritten draft signed by the President of Congress John Hancock and the Secretary Charles Thomson was then sent a few blocks away to the printing shop of John Dunlap.
وخلال الليل تم عمل ما بين 150 و200 نسخة، تعرف الآن باسم "نشرات دنلاب النقدية".	Through the night between 150 and 200 copies were made, now known as "Dunlap broadsides".
كانت أول قراءة عامة للوثيقة بواسطة جون نيكسون في باحة قاعة الاستقلال في الثامن من تموز.	The first public reading of the document was by John Nixon in the yard of Independence Hall on July 8.
أُرسلت واحدة منهم إلى جورج واشنطن في السادس من يوليو، وقد قرأها على قوّاته في نيويورك في التاسع من يوليو. ووصلت نسخة منها إلى لندن في العاشر من أغسطس.	One was sent to George Washington on July 6, who had it read to his troops in New York on July 9. A copy reached London on August 10.
تمثل مطويات دنلاب الخمس والعشرون أقدم النسخ الباقية من مستند إعلان الاستقلال الأمريكي، ولكن النسخة الأصلية المكتوبة بخط اليد لم يُكتب لها النجاة.	The 25 Dunlap broadsides still known to exist are the oldest surviving copies of the document. The original handwritten copy has not survived.
