نعم! يُعتبر الملك توت عنخ آمون، الذي يُطلق عليه أحياناً لقب "الملك توت" أو "الملك الصبي"، من أحد أكثر الملوك المصريين القدماء شهرة في العصر الحديث.	Yes! King Tutankhamun, sometimes referred to as "King Tut" or "The Boy King", is one of the most well known ancient Egyptian kings in modern times.
الجدير بالاهتمام، لم يكن يعتبر أنه ذو أهمية في الأيام الغابرة ولم يُذكر في أغلب لوائح الملوك.	Interestingly, he was not considered to be very important in ancient times and was not recorded on most ancient king lists.
ومع ذلك، فإن اكتشاف قبره في عام 1922 جعله من المشاهير. في حين نُهب العديد من مقابر الماضي، إلا أن هذا القبر لم يُعبث به تقريباً.	However, the discovery of his tomb in 1922 made him a celebrity. While many tombs of the past were robbed, this tomb was left virtually undisturbed.
معظم القطع المدفونة مع توت عنخ آمون محفوظة بشكل جيد، بما في ذلك الآلاف من القطع الأثرية المصنوعة من المعادن الثمينة والأحجار النادرة.	Most of the items buried with Tutankhamun have been well preserved, including thousands of artefacts made from precious metals and rare stones.
استطاع اختراع العجلات ذات العوارض أن يجعل العربات الآشورية أخفّ وزناً وأسرع وأكثر استعداداً لتجاوُز الجنود والعربات الأخرى.	The invention of spoke wheels made Assyrian chariots lighter, faster, and better prepared to outrun soldiers and other chariots.
يمكن أن تخترق السهام المُطلقة من الأقواس القاتلة دروع الجنود المتنافسين. قدم الآشوريون أول سلاح فرسان في حوالي عام 1000 قبل الميلاد.	Arrows from their deadly crossbows could penetrate the armor of rival soldiers. About 1000 B.C., the Assyrians introduced the first cavalry.
سلاح الفرسان هو جيش يقاتل على ظهور الخيل. لم يكن السرج قد اخترع بعد، لذلك قاتل الفرسان الآشوريون على ظهور خيولهم العارية.	A cavalry is an army that fights on horseback. The saddle had not yet been invented, so the Assyrian cavalry fought on the bare backs of their horses.
نعرف الكثير من السياسيين والعلماء والفنانين اليونانيين. قد يكون الشخص الأكثر شهرة الذين نعرفهم من هذه الثقافة هو هوميروس، الشاعر الأسطوري الذي فقد بصره، والذي ألف رائعتين من روائع الأدب اليوناني، ألا وهما الإلياذة والأوديسا.	We know many Greek politicians, scientists, and artists. Possibly the most known person of this culture is Homer, the legendary blind poet, who composed two masterpieces of Greek literature: the poems Iliad and Odyssey.
يُعد سوفوكليس وأريستوفان من كتاب المسرحيات المشهورين حتى الآن وتعد مسرحياتهما من أعظم الأعمال في الأدب العالمي.	Sophocles and Aristophanes are still popular playwrights and their plays are considered to be among the greatest works of world literature.
يونانيٌ شهيرٌ آخر هو عالم الرياضيات "فيثاغورس"، وهو غالباً ما عُرف بنظريته المشهورة حول العلاقات بين أضلاع المثلث القائم.	Another famous Greek is a mathematician Pythagoras, mostly known for his famous theorem about relations of the sides of right triangles.
في حين أن معظم طعامهم سيكون مألوفًا لنا، فإن الرومان لديهم نصيبهم من عناصر العيد الغريبة أو غير العادية، بما في ذلك الخنازير البرية، والطاووس، والقواقع، ونوع من القوارض يسمى الزغبة	While most of their food would be familiar to us, Romans did have their share of strange or unusual feast items, including wild boar, peacock, snails, and a type of rodent called a dormouse
كان هناك تباين آخر هو أنه بينما كان الفقراء والنساء يأكلون طعامهم وهم جالسون على المقاعد، كان الرجال الأغنياء يحبون إقامة الولائم سوية حيث يتكئون على جانبهم أثناء تناولهم واجباتهم.	Another difference was that while the poor people and the woman ate their food while sitting in chairs, the rich men liked to have banquets together where they would lounge on their sides while they ate their meals.
لم يكن من الممكن أن تتضمن الوَجَباتِ الرومانية القديمةِ الأطعمةَ التي جاءت إلى أوروبا من أمريكا أو من آسيا في القرون اللاحقة.	Ancient Roman meals couldn't have included foods that came to Europe from America or from Asia in later centuries.
على سبيل المثال، لم يكن لديهم ذرة، أو طماطم، أو بطاطس، أو كاكاو ولم يتذوق أي من الرومان القدامى الديك الرومي.	For instance, they didn't have corn, nor tomatoes, nor potatoes, nor cocoa, and no ancient Roman ever tasted a turkey.
بنى البابليون لكل إله من آلهتهم معبداً رئيسياً وكان يُعتبر بيت الإله.	The Babylonians built each of their gods a primary temple that was considered the home of the god.
كان الناس يقدمون القرابين إلى الآلهة ويحاول الكهنة تلبية احتياجات الآلهة خلال الاحتفالات والأعياد.	People would bring sacrifices to the gods and the priests would try to attend to the needs of the gods through ceremonies and festivals.
لكل معبد ساحة مفتوحة تؤدي إلى خلوة آمنة يمكن للكهنة فقط أن يدخلوها.	Each temple had an open temple courtyard and then an inner sanctuary that only the priests could enter.
بُنيت أحيانًا أبراج فريدة على شكل أهرامات تسمى زقورة لتكون جزء من المعابد.	Sometimes special pyramid shaped towers, called ziggurats, were built to be a part of the temples.
كانت قمة البرج ملاذاً آمناً للإله.	The top of the tower was special sanctuary for the god.
في مناخ الشرق الأوسط الدافئ، لم يكن للمنزل أهميّة كبيرة.	In the warm climate of the Middle East, the house was not so important.
كانت معظم حياة العائلة العبرية في الهواء الطلق.	Most of the life of the Hebrew family happened in the open air.
كانت النساء تطبخ في الفناء؛ كانت المتاجر مجرد أنضاد مفتوحة تطل على الشارع. استُخدم الحجر في بناء المنازل.	Women did the cooking in the yard; stores were just open counters looking into the street. Stone was used for building houses.
لم تكن هناك غابات كبيرة في أرض كنعان، لذلك كان الخشب باهظ الثمن.	There were no large forests in the land of Canaan, so wood was extremely expensive.
لقد سكن غرينلاند القليل من البشر. يُحكى في الملحمات الإسكندنافية أن إريك الأحمر نُفى من أيسلندا بتهمة القتل، وعندما سافر غرباً، وجد غرينلاند وأطلق عليها غرينلاند.	Greenland was settled sparsely. In the Norse sagas they say that Erik the Red was exiled from Iceland for murder, and when travelling further west, found Greenland and named it Greenland.
بغض النظر عن اكتشافه فإن قبائل الإسكيمو كانت تعيش هناك سابقاً.	But regardless of his discovery, Eskimo tribes were already living there at the time.
كانت هناك اختلافات كثيرة بين الناس والملوك والعادات والتاريخ في دول "الدنمارك" و"السويد" و"النرويج" و"أيسلندا"،على الرغم من أن كل دولة كانت "إسكندنافية".	Though each country was 'Scandinavian', there were many differences between the people, kings, customs and history of Denmark, Sweden, Norway and Iceland.
الحضارة هي ثقافةٌ فرديةٌ مشتركةٌ بين مجموعةٍ كبيرة من الناس الذين يعيشون ويعملون بشكل تعاوني، مجتمع.	A civilization is a singular culture shared by a significant large group of people who live and work co-operatively, a society.
أصل كلمة حضارة من اللاتينية civilis، والتي تعني مدني، والتي تتعلق باللاتينية سيفيس، وتعني مواطن، وسيفيتاس، تعني مدينة أو دولة المدينة، وهذا أيضاً يحدد بطريقة الكتلة المجتمعية.	The word civilization comes from the Latin civilis, meaning civil, related to the Latin civis, meaning citizen, and civitas, meaning city or city-state, and that also somehow defines the size of the society.
إن المدن المستقلة ذاتياً هي بمثابة أسلاف الأمم. إن الثقافة الحضارية تعني ضمناً نقل المعرفة عبر عدة أجيال، بصمة ثقافية متبقية ونشر المعرفة بشكل عادل.	City-states are the precursors of nations. A civilizational culture implies the passing on of knowledge across several generations, a lingering cultural footprint and fair dissemination.
تتلاشى الثقافات الصغرى في كثير من الأحيان دون أن تترك أي دليل تاريخي فعلي ولا يُعترف بها باعتبارها حضارات حقيقية.	Minor cultures often vanish without leaving relevant historic evidence and fail to be recognized as proper civilizations.
كان لدى الصين القديمة طريقةٌ فريدةٌ لعرض الفترات الزمنية المختلفة؛ كانت كل مرحلة من مراحل الصين أو كل أسرة كانت في السلطة من نوعٍ مختلفٍ.	Ancient China had a unique way of showing different time periods; each stage of China or each family that was in power was a distinctive dynasty.
بالإضافة إلى ذلك، كان هناك بين كل سلالة حاكمة عصرٌ غير مستقرٍ من المقاطعات المقسمة. أشهر هذه الفترات كانت حقبة الممالك الثلاث التي دامت 60 عاماً بين أسرة هان وسلالة جين.	Also between each dynasty was an unstable age of divided provinces. The best-known of these periods was the Three Kingdoms epoch taking place for 60 years between the Han and the Jin Dynasty.
نشأت خلال هذه الفترات حرب شرسة بين العديد من النبلاء سعيًا إلى العرش.	During these periods fierce warfare took place between many nobles fighting for the throne.
حقبة الممالك الثلاثة هي واحدة من أكثر الحقب دمويةً في تاريخ الصين القديمة مات آلاف من الناس خلال القتال في سبيل الجلوس على أعلى المقاعد في القصر الكبير في شيان.	The Three Kingdoms was one of the bloodiest eras in Ancient China’s history thousands of people died fighting to sit in the highest seat in the grand palace at Xi’an.
