أنماط التفكير التجميعي هي أساليب لحل المشاكل تجمع أفكار أو مجالات مختلفة لإيجاد حل.	Convergent thinking patterns are problem solving techniques that unite different ideas or fields to find a solution.
تركز هذه العقلية على السرعة والمنطق والدقة وأيضاً على تحديد الحقائق وإعادة تطبيق التقنيات الموجودة وجمع المعلومات.	The focus of this mindset is speed, logic and accuracy, also identification of facts, reapplying existing techniques, gathering information.
والعامل الأكثر أهمية في هذه العقلية هو: لا توجد سوى إجابة واحدة صحيحة. لا تفكر إلا في إجابتين، وهما إجابة صحيحة أو خاطئة.	The most important factor of this mindset is: there is only one correct answer. You only think of two answers, namely right or wrong.
يَرْتبط هذا النوع من التفكير بعلمٍ معين أو إجراءاتٍ قياسيةٍ.	This type of thinking is associated with certain science or standard procedures.
فالأشخاص الذين لديهم هذا النوع من التفكير لديهم تفكير منطقي وهم قادرون على حفظ الأنماط وحل المشاكل والعمل على الاختبارات العلمية.	People with this type of thinking have logical thinking, are able to memorize patterns, solve problems and work on scientific tests.
الإنسان هو أكثر الكائنات موهبةً في قراءة عقول الآخرين.	Humans are by far the most talented species in reading the minds of others.
يعني ذلك أننا قادرون على التنبؤ بشكل ناجح بمنظور البشر الآخرين أو نواياهم أو إيمانهم أو معرفتهم أو رغبتهم.	That means we are able to successfully predict what other humans perceive, intend, believe, know or desire.
من بين هذه القدرات، فهم نية الآخرين أمرٌ بالغُ الأهمية. حيث يسمح لنا بتحليل الغموض المحتمل في الأفعال الجسدية.	Among these abilities, understanding the intention of others is crucial. It allows us to resolve possible ambiguities of physical actions.
على سبيل المثال، إذا رأيت شخصاً يكسر نافذة سيارة، فمن المحتمل أن تفترض أنه كان يحاول سرقة سيارة شخص غريب.	For example, if you were to see someone breaking a car window, you would probably assume he was trying to steal a stranger’s car.
ويمكن الحكم عليه بشكل مختلف إذا فقد مفاتيح سيارته وكانت سيارته هي التي يحاول اقتحامها.	He would need to be judged differently if he had lost his car keys and it was his own car that he was trying to break into.
يعتمد التصوير بالرنين المغناطيسي على ظاهرة فيزيائية تسمى الرنين المغناطيسي النووي (NMR)، والتي اكتشفت في ثلاثينيات القرن الماضي عن طريق فيليكس بلوخ (من جامعة ستانفورد) وإدوارد بورسيل (من جامعة هارفارد)	MRI is based on a physics phenomenon called nuclear magnetic resonance (NMR), which was discovered in the 1930s by Felix Bloch (working at Stanford University) and Edward Purcell (from Harvard University).
في هذا الرنين، تجعل المجالات المغناطيسيّة والموجات الراديويّة الذرّات تبعث إشارات راديو دقيقة.	In this resonance, magnetic field and radio waves cause atoms to give off tiny radio signals.
في عام 1970، اكتشف رايموند داماديان، وهو طبيب وعالم أبحاث، الأساس الذي بُني عليه استخدام التصوير بالرنين المغناطيسي كأداة للتشخيص الطبّي.	In the year 1970, Raymond Damadian, a medical doctor and research scientist, discovered the basis for using magnetic resonance imaging as a tool for medical diagnosis.
بعد أريع سنوات، تم منح براءة اختراع، والتي كانت أول براءة اختراع في العالم يتم منحها في مجال التصوير بالرنين المغناطيسي.	Four years later a patent was granted, which was the world's first patent issued in the field of MRI.
في عام 1977 استكمل الدكتور داماديان إنشاء أول ماسح ضوئي للتصوير بالرنين المغناطيسي "لكامل الجسم"، والذي يسمى اليوم ب"الذي لا يقهر".	In 1977, Dr. Damadian completed the construction of the first “whole-body” MRI scanner, which he called the ”Indomitable”.
توفّر البيانات المرتبطة بعلم الأعصاب أدلّة ملموسة للمنهج النظري في تقصّي المعرفة. بذلك تعمل على تقلُّص منطقة البحث وتجعلها أكثر دقّة بكثير.	Neurobiological data provide physical evidence for a theoretical approach to the investigation of cognition. Therefore it narrows the research area and makes it much more exact.
يدعم الترابط بين علم أمراض الدماغ والسلوك العلماء في أبحاثهم.	The correlation between brain pathology and behaviour supports scientists in their research.
من المعروف منذ فترة طويلة أن الأنواع المختلفة من تلف الدماغ، والصدمات، والآفات، والأورام تؤثر على السلوك وتسبب تغيرات في بعض الوظائف العقلية.	It has been known for a long time that different types of brain damage, traumas, lesions, and tumours affect behaviour and cause changes in some mental functions.
يسمح لنا ظهور التقنيات الجديدة برؤية تركيبات وعمليات الدماغ و إجراء أبحاث عليها فيها بشكل لم يسبق له مثيل.	The rise of new technologies allows us to see and investigate brain structures and processes never seen before.
هذا يوفر لنا الكثير من المعلومات والمواد لبناء نماذج المحاكاة التي تساعدنا على فهم العمليات في أذهاننا.	This provides us with a lot of information and material to build simulation models which help us to understand processes in our mind.
بالرغم من أن للذكاء الاصطناعي دلالة قوية للخيال العلمي، فإنه يشكل فرعاً هاماً للغاية من علوم الكمبيوتر، ويتعامل مع السلوك والتعلم والتكيف الذكي في الآلة.	Although AI has a strong connotation of science fiction, AI forms a very important branch of computer science, dealing with behavior, learning and intelligent adaptation in a machine.
يتضمن البحث في الذكاء الاصطناعي صنع الآلات للقيام بالمهام التي تتطلب سلوكاً ذكياً بشكلٍ آليٍ.	Research in AI involves making machines to automate tasks that require intelligent behavior.
تتضمن الأمثلة التحكم والتخطيط ووضع الجداول والقدرة على الإجابة على تشخيصات الزبائن وأسئلتهم، وإضافة إلى ذلك التعرف على خط اليد والصوت والوجه.	Examples include control, planning and scheduling, the ability to answer customer diagnoses and questions, as well as handwriting recognition, voice and face.
أصبحت مثلَ هذه الأشياء مجالاتٍ منفصلةٍ تركز على تقديم حلولٍ لمشاكل الحياة الحقيقيّة.	Such things have become separate disciplines, which focus on providing solutions to real life problems.
يُستخدم نظام الذكاء الاصطناعي الآن في حقول الاقتصاد، والطب، والهندسة، والجيش، كما تم استخدامه لبناء عدة تطبيقات برمجية على الحواسب المنزلية وألعاب الفيديو.	The AI ​​system is now often used in the fields of economics, medicine, engineering and the military, as has been built in several home computer and video game software applications.
