بينما أصبحت القدرة على اقتناء المعرفة والتعلم متغيرة بالطريقة المذكورة أعلاه، فإن المعدل الأساسي لاقتناء المعرفة قد تغير.	As the ability to obtain knowledge and to learn changed in such a way as mentioned above the base rate at which knowledge was obtained changed.
وسيلة الحصول علي المعلومات كانت مختلفة. لم يعد الضغط يتمثل في التذكر الفردي، لكن القدرة على تذكر النص حصلت علي التركيز الأكبر.	The approach to obtaining information was different. No longer did pressure reside within individual recall, but the ability to recall text became more of a focus.
وفي جوهر الأمر، أحدث عصر النهضة تغييراً كبيراً في نهج التعلم ونشر المعرفة.	In essence, the Renaissance made a significant change in the approach to learning and the dissemination of knowledge.
تقوم الشركات الإعلامية بشكل روتيني بالكذب حول الغرض من ذلك، بدعوى "منع القرصنة".	The media companies routinely lie about the purpose of this, claiming that it is to "prevent piracy".
في الحقيقة، لا تؤثر رموز المناطق مطلقاً على النسخ غير القانوني؛ سوف يتم تشغيل نسخة بت-مقابل-بت من القرص بشكل مقبول على أي جهاز حيث سوف يتم تشغيل النسخة الأصلية.	In fact, region codes have absolutely no effect on illegal copying; a bit-for-bit copy of a disk will play just fine on any device where the original will.
الغاية الحقيقية هي أن تعطي تلك الشركات سيطرة أكبر على أسواقهم؛ يدور الأمر كله حول ربح الأموال.	The actual purpose is to give those companies more control over their markets; it's all about money spinning.
لن تحتاج إلى استخدام شركة محمول حيث تقيم أو تسافر لأنه يتم توجيه المكالمات من خلال الإنترنت.	Because calls are routed over the Internet, you do not need to use a phone company located where you live or where you travel.
لا يوجد أيضاً أي شرطٍ للحصول على رقمٍ محلي من المجتمع الذي تعيش فيه؛ يمكنك الحصول على اتصال إنترنت عبر الأقمار الصناعية في براري تشيكن في ألاسكا واختيار رقم يَدّعِي أنك في ولاية أريزونا المشمسة.	There is also no requirement that you obtain a local number from the community in which you live; you can obtain a satellite Internet connection in the wilds of Chicken, Alaska and select a number which claims you're in sunny Arizona.
عادةً، يتعيّن عليك شراء رقم عالمي بشكل منفصل يسمح لهواتف شبكة الهاتف العامّة بالاتصال بك. يُحدث المكان الذي يأتي منه الرّقم فرقاً للأشخاص الذين يتصلون بك.	Often, you have to buy a global number separately that allows PSTN phones to call you. Where the number is from makes a difference for people calling you.
تطبيقات مترجم النصوص الفوري هي تطبيقات بإمكانها ترجمة أجزاء كاملة من النص من لغة إلى أخرى بصورة تلقائية.	Real-time text translator apps – applications that are capable of automatically translating whole segments of text from one language into another.
تستطيع بعض التطبيقات من هذه الفئة ترجمة النصوص الموجودة على إشارات أو أشياء أخرى في العالم الحقيقي المكتوبة بلغات أجنبية عندما يشير المستخدم بالهاتف الذكي باتجاه تلك الأشياء.	Some of the applications in this category can even translate texts in foreign languages on signs or other objects in the real world when the user points the smartphone towards those objects.
تحسّنت محركات الترجمة بشكل كبير، والآن غالباً ما تقدم ترجمات صحيحة إلى حد كبير (ونادراً ما تفدم هراءً)، لكن يجب الحذر، لأنهم قد يخطئون كليّاً.	The translation engines have improved dramatically, and now often give more or less correct translations (and more seldom gibberish), but some care is due, as they still may have gotten it all wrong.
أحد أبرز تطبيقات هذه الفئة تطبيق ترجمة Google، الذي يسمح لك بالترجمة أثناء عدم الاتصال بالإنترنت بعد تنزيل بيانات اللغة التي تريدها.	One of the most prominent apps in this category is Google Translate, which allows offline translation after downloading the desired language data.
قد يكون استخدام تطبيقات نظام التموضع العالمي (جي بي إس) على هاتفك الذكي أسهل الطرق وأكثرها راحةً للتنقل في بلدٍ غير بلدك.	Using GPS navigation apps on your smartphone can be the easiest and most convenient way to navigate when out of your home country.
فهو يمكنه توفير المال من خلال شراء خرائط جديدة لنظام تحديد المواقع العالمي (GPS)، أو جهاز مستقل لنظام تحديد المواقع العالمي (GPS)، أو استئجار جهاز من شركة لتأجير السيارات.	It can save money over buying new maps for a GPS, or a standalone GPS device or renting one from a car rental company.
إن لم يكن لديك اتصال بالإنترنت في هاتفك، أو عندما يكون خارج النطاق، فقد يكون أداؤه محدوداً أو غير متاح.	If you don't have a data connection for your phone, or when it is out of range, their performance can be limited or unavailable.
يحتوي كل متجر بقالة على صف مُربك من بطاقات الهاتف المدفوعة مُقدماً التي يمكن استخدامها في الهواتف العمومية أو في الهواتف العادية.	Every corner store is filled with a confusing array of pre-paid phone cards that can be used from pay phones or ordinary telephones.
تتخصص بعض البطاقات في تقديم أسعار مكالمات مواتية لمجموعات محددة من البلدان، في حين أن معظم البطاقات جيدة للاتصال بأي مكان.	While most cards are good for calling anywhere, some specialise in providing favourable call rates to specific groups of countries.
يتم الوصول إلى هذه الخدمات في الأغلب عن طريق رقم هاتف مجاني يمكن الاتصال به من معظم الهواتف مجاناً.	Access to these services is often through a toll-free telephone number that can be called from most phones without charge.
يجمع الإنترنت بين عناصر كلٍّ من التواصل الجماهيري والشخصي.	The Internet combines elements of both mass and interpersonal communication.
تؤدي الخصائص المميزة للإنترنت إلى أبعاد إضافية من حيث نهج الاستخدامات وطرق الإشباع.	The distinct characteristics of the Internet lead to additional dimensions in terms of the uses and gratifications approach.
فعلى سبيل المثال، يقترح البعض "التعلم" و"التنشئة الاجتماعية" كدوافع مهمّة لاستخدام شبكة الإنترنت (جيمس وغيره، 1995).	For example, “learning” and “socialization” are suggested as important motivations for Internet use (James et al., 1995).
تم التعرف على "المشاركة الشخصية" و "العلاقات المستمرة" كجوانب تحفيزية جديدة بواسطة إيمي ومكورد (1998) عندما درسوا رد فعل الجمهور على مواقع الويب.	“Personal involvement” and “continuing relationships” were also identified as new motivation aspects by Eighmey and McCord (1998) when they investigated audience reactions to websites.
أدى استخدام تسجيلات الفيديو إلى اكتشافات هامة في مجال تفسير التعابير الدقيقة للوجه، وهي حركات للوجه تستمر لبضع أجزاء من الثانية الواحدة.	The use of video recording has led to important discoveries in the interpretation of micro-expressions, facial movements which last a few milliseconds.
ويُدّعى على وجه الخصوص أن المرء يستطيع أن يكتشف ما إذا كان الشخص يكذبمن خلال تفسير التعبيرات الدقيقة بشكل صحيح.	In particular, it is claimed that one can detect whether a person is lying by interpreting micro-expressions correctly.
وقد أشارَ أوليفر ساكس في ورقته إلى أنّ خطاب الرّئيس يشير إلى أنّ الأشخاص غير القادرين على فهم الكلام بسبب تلفِ الدّماغ يكونون قادرين على تقييم الصّدق بدقةٍ.	Oliver Sacks, in his paper The President's Speech, indicated how people who are unable to understand speech because of brain damage are nevertheless able to assess sincerity accurately.
بل إنه يطرح فكرة أن تكون هذه القدرات في تحليل السلوك البشري مشتركة مع بعض الحيوانات، مثل الكلاب الأليفة.	He even suggests that such abilities in interpreting human behavior may be shared by animals such as domestic dogs.
في المواقع البعيدة، مع غياب تغطية الهاتف الخلوي، قد يكون الهاتف المتصل بالقمر الصناعي هو الخيار الوحيد.	In remote locations, without cell phone coverage, a satellite phone may be your only option.
الهاتف الذي يعمل بالأقمار الصناعية لا يعد عموماً بديلاً عن الهاتف المحمول، إذ يجب أن تكون في الخارج في وجود خط رؤية واضح مع القمر الصناعي لإجراء مكالمةٍ هاتفيةٍ.	A satellite phone is not generally a replacement for a mobile phone, as you have to be outdoors with clear line of sight to the satellite to make a phone call.
تُستخدم الخدمة بشكل متكرر من خلال الشحن، بما في ذلك زوارق التنزه، وكذلك البعثات الاستكشافية التي لديها احتياجات للبيانات والصوت عن بعد.	The service is frequently used by shipping, including pleasure craft, as well as expeditions who have remote data and voice needs.
لابد من وجود مزوِّد خدمة هاتف محلي قادر على تقديم مزيد من المعلومات عن طرق الاتصال بهذه الخدمة.	Your local telephone service provider should be able to give more information about connecting to this service.
