قبل ظهور برنامج "البرنامج اليومي" وبرنامج "تقرير كولبرت" بفترة طويلة تخيل هيك وجونسون منشورًا يحاكي الأخبار-والتقارير الإخبارية-عندما كانا طالبين بجامعة ويسكونسن عام 1988.	Long before The Daily Show and The Colbert Report, Heck and Johnson envisioned a publication that would parody the news—and news reporting—when they were students at UW in 1988.
منذ نشأته، أصبح ذي أنيون بمثابة إمبراطورية محاكاة إخبارية ساخرة حقيقية، مع إصدار مطبوع، وموقع على شبكة الإنترنت جذب 5,000,000 زائر فريد في شهر أكتوبر، وإعلانات شخصية، وشبكة إخبارية تعمل على مدار 24 ساعة، والبث الصوتي على الإنترنت، وأطلس عالمي أُطلق مؤخراً يسمى عالمنا الغبي.	Since its inception, The Onion has become a veritable news parody empire, with a print edition, a website that drew 5,000,000 unique visitors in the month of October, personal ads, a 24 hour news network, podcasts, and a recently launched world atlas called Our Dumb World.
آل غور والجنرال تومي فرانكس يتحدثان في عجالة بشأن العناوين المفضلة لديهما (كان المفضل لغور عندما أصدرت جريدة ذي أنيون أنه هو وتيبر يمارسان أفضل جنس في حياتهما بعد هزيمته في المجمع الانتخابي عام 2000).	Al Gore and General Tommy Franks casually rattle off their favorite headlines (Gore's was when The Onion reported he and Tipper were having the best sex of their lives after his 2000 Electoral College defeat).
أثَّر العديد من كُتابهم تأثيرًا كبيرًا على عروض المحاكاة الساخرة الإخبارية لجون ستيوارت وستيفن كولبرت.	Many of their writers have gone on to wield great influence on Jon Stewart and Stephen Colbert's news parody shows.
الحدث الفني يكون أيضاً جزء من حملة أقامها مجلس مدينة بوخارست الذي يطمح في إعادة إحياء صورة العاصمة الرومانية كعاصمة مبدعة وزاهية.	The artistic event is also part of a campaign by the Bucharest City Hall that seeks to relaunch the image of the Romanian capital as a creative and colourful metropolis.
ستكون المدينة الأولى في جنوب شرق أوروبا التي تستضيف CowParade، أكبر حدث فني عام في العالم، بين يونيو وأغسطس من هذا العام.	The city will be the first in southeastern Europe to host CowParade, the world's largest public art event, between June and August this year.
وقد تلقى الفيلم الذي يضم رايان غوسلينغ وإيما ستون، ترشيحات في جميع الفئات الرئيسية.	The movie, featuring Ryan Gosling and Emma Stone, received nominations in all major categories.
تلقى جوسلينغ وستون ترشيحات لأفضل ممثل وممثلة على الترتيب.	Gosling and Stone received nominations for Best Actor and Actress respectively.
تشمل الترشيحات الأخرى جائزة أفضل فيلمٍ ومخرجٍ وتصويرٍ سينمائيٍّ وتصميم أزياء ومونتاج وموسيقى تصويرية و تصميم إنتاج و تعديل الصوت ومزج الصوت وسيناريو أصلي.	The other nominations include Best Picture, Director, Cinematography, Costume Design, Film-editing, Original Score, Production Design, Sound Editing, Sound Mixing and Original Screenplay.
تلقت أغنيتان من الفيلم، تجربة أداء (The Fools Who Dream) وCity of Stars، ترشيحات لأفضل أغنية أصلية. تلقى استوديو Lionsgate 26 ترشيحاً — أكثر من أي استوديو آخر.	Two songs from the movie, Audition (The Fools Who Dream) and City of Stars, received nominations for best original song. Lionsgate studio received 26 nominations — more than any other studio.
على الرغم من أن وينفري كانت متأثرةً في وداعها، إلا أنها أوضحت لجمهورها أنها ستعود.	Although Winfrey was tearful in her farewell, she made it clear to her fans she will be back.
"هذا لن يكون وداعاً. هذا هو إغلاق فصل وبداية فصل جديد."	"This is not going to be goodbye. This is the closing of one chapter and the opening of a new one."
وصف موقع المحطّة الإلكتروني العمل بأنه "مسرح إذاعي على الطريقة القديمة، بانعطاف غريب الأطوار، جديد وصارخ!"	The station's web site describes the show as "old school radio theater with a new and outrageous geeky spin!"
في أيامه الأولى، أُذيع البرنامج حصراً على موقع راديو الإنترنت الموجود منذ فترة طويلة "توجي نت راديو"، وهو الموقع الذي يركز على الراديو الحواري.	In its early days, the show was featured solely at the long-running internet radio site TogiNet Radio, a site focused on talk radio.
في أواخر عام 2015، أنشأت "توجي نت" راديو "أسترو نت " كمحطة إذاعية تابعة.	In late 2015, TogiNet established AstroNet Radio as a subsidiary station.
عرض البرنامج في الأصل ممثلي صوت الهواة، من محلية إلى شرق تكساس.	The show originally featured amateur voice actors, local to East Texas.
القصة التي قُدمت بالأوبرا الفرنسية، لكاميل سان ساينز، هي قصة فنان "حياته محكومة بحب المخدرات واليابان."	The story presented in the French opera, by Camille Saint-Saens, is of an artist "whose life is dictated by a love for drugs and Japan."
ونتيجة لذلك، يدخن الفنانون لفائف القنب على خشبة المسرح، ويشجع المسرح نفسه الجمهور على مشاركتهم في ذلك.	As a result, the performers smoke cannabis joints on stage, and the theatre itself is encouraging the audience to join in.
نُقل المصور إلى مركز رونالد ريجان الطبي بجامعة كاليفورنيا حيث وافته المنية لاحقاً.	The photographer was transported to Ronald Reagan UCLA Medical Center, where he subsequently died.
وبحسب ما ورد في التقارير، فإنه كان في العشرينيات من عمره. وقال بيبر في بيان: "بينما لم أكن حاضراً ولم أتواجد بشكل مباشر في هذا الحادث المأساوي، فإن أفكاري ودعواتي مع عائلة الضحية."	He was reportedly aged in his 20s. In a statement, Bieber said "[w]hile I was not present nor directly involved with this tragic accident, my thoughts and prayers are with the family of the victim."
تبين موقع TMZ الإخباري الترفيهي أن المصور أوقف مركبته على الجانب الآخر من شارع سيبولفيدا بوليفارد وحاول التقاط صور لحاجز الشرطة قبل عبور الطريق والمتابعة، مما دفع ضابط شرطة دورية الطرق السريعة في كاليفورنيا إلى عمل توقيف لحركة المرور لأمره بالعودة مرتين.	Entertainment news website TMZ understands the photographer stopped his vehicle on the other side of Sepulveda Boulevard and attempted to take pictures of the police stop before crossing the road and continuing, prompting the California Highway Patrol police officer conducting the traffic stop to order him back across, twice.
وبحسب ما ذكرته الشّرطة، فإنه ليس من المرجّح أن يواجه سائق المركبة التي صدمت المصوّر أيّ تهم جنائيّة.	According to police, the driver of the vehicle that hit the photographer is unlikely to face criminal charges.
قبل "ذا سيمبسونز" عمل سايمون في عدة عروض في مناصب مختلفة.	Before The Simpsons Simon had worked on several shows in various positions.
وخلال الثمانينيات من القرن الماضي، عمل في عروض مثل تاكسي و تشيرز وذا تريسي أولمان شو.	During the 1980s he worked on shows such as Taxi, Cheers, and The Tracy Ullman Show.
في سنة 1989 ساهم في خلق سمبسنز مع بروكس وكرونينغ، كان مسؤولاً عن توظيف أول فريق كتابة لهذا العرض.	In 1989 he helped create The Simpsons with Brooks and Groening, and was responsible for hiring the show's first writing team.
بالرغم من مغادرته العرض في سنة 1993، إلا أنه احتفظ بلقب المنتج التنفيذي، واستمر في تلقي عشرات الملايين من الدولارات كل موسم من الحقوق الأدبية.	Despite leaving the show in 1993 he kept the title of executive producer, and continued to receive tens of millions of dollars every season in royalties.
أثناء كلمته في معرض طوكيو لألعاب الفيديو يوم الخميس، أزاح رئيس شركة نينتندو ساتورو إواتا الستار عن تصميم نظام التحكم لكونسول نينتندو الثوري الجديد.	At Thursday's keynote presentation of the Tokyo Game Show, Nintendo president Satoru Iwata unveiled the controller design for the company's new Nintendo Revolution console.
مشابهةً بجهاز التحكم عن بُعد للتلفاز، يستخدم جهاز التحكم مستشعرين موضوعين بالقرب من تلفزيون المستخدم لتحديد موقعه في الفضاء ثلاثي الأبعاد.	Resembling a television remote, the controller uses two sensors placed near the user's television to triangulate its position in three-dimensional space.
سَيسْمح ذلك للاعبين بالتحكم في الأفعال والحركات في ألعاب الفيديو عن طريق التلويح بالجهاز في الهواء.	This will allow players to control actions and movements in video games by moving the device through the air.
وقال وفقًا لنص المؤتمر الصحفي: "إنها لطيفة للغاية كما تغني بشكل جيد جدًا".	"She’s very cute and sings quite well, too," he said according to a transcript of the news conference.
"لقد تأثرت في كل مرة كنا نجري فيها تدريبًا على هذا، من أعماق قلبي".	"I was moved every time we did a rehearsal on this, from the bottom of my heart."
