في يوم الاثنين، أعلن علماء من كلية الطب بجامعة ستانفورد عن اختراع أداة تشخيصية جديدة يمكنها تصنيف الخلايا حسب النوع: شريحة صغيرة قابلة للطباعة يمكن تصنيعها باستخدام طابعات نفاثة للحبر قياسية مقابل حوالي سنت أمريكي واحد لكل منها.	On Monday, scientists from the Stanford University School of Medicine announced the invention of a new diagnostic tool that can sort cells by type: a tiny printable chip that can be manufactured using standard inkjet printers for possibly about one U.S. cent each.
يقول الباحثون الرئيسيون أن هذا قد يؤدي إلى الكشف المبكر للسرطان والسل وفيروس العوز المناعي البشري والملاريا في البلدان ذوات الدخل المنخفض، والتي تكون فيها معدلات النجاة من الأمراض مثل سرطان الصدر نصف معدلات البلدان الأغنى.	Lead researchers say this may bring early detection of cancer, tuberculosis, HIV and malaria to patients in low-income countries, where the survival rates for illnesses such as breast cancer can be half those of richer countries.
كما تؤكّد الحكومة الأيرلندية على الضرورة الملحّة لتشريعٍ برلمانيٍ لتصحيح الوضع.	The Irish government is stressing the urgency of parliamentary legislation to rectify the situation.
أفاد متحدثٌ باسم الحكومة: "من المهم الآن سواءً من منظور الصّحة العامّة أو من منظور العدالة الجنائية أن يتمّ سنّ التّشريع في أسرع وقتٍ ممكنٍ".	"It is now important from both a public health and criminal justice perspective that the legislation be enacted as soon as possible", said a government spokesperson.
وأعرب وزير الصحة عن مخاوفه بشأن صحة الأفراد الذين يقومون باستغلال الشرعية المؤقّتة للمواد المتعلقة، والإدانات المتعلقة بالمخدرات الصادرة منذ أن دخلت التغييرات غير الدستورية قيد التنفيذ.	The Health Minister expressed concern both for the welfare of individuals taking advantage of the temporary legality of the substances involved, and for drug-related convictions handed down since the now-unconstitutional changes came into effect.
نادية، المولودة في 17 سبتمبر 2007، بعمليّة ولادة قيصريّة في عيادة توليد في أليسك، روسيا، وكان وزنها الضخم 17 رطل وأوقية واحدة.	Nadia, born on September 17, 2007, by Cesarean section at a maternity clinic in Aleisk, Russia, weighed in at a massive 17 pounds 1 ounce.
صرحت الأم قائلةً، "لقد كنا جميعاً ببساطة في حالة صدمة".	"We were all simply in shock," the mother stated.
عندما سُئلت عما قاله الأب، أجابت "لم يستطع أن يقول شيئًا - لقد تسمر هناك، وكانت عيناه ترمش فحسب".	When asked what the father said, she answered "He couldn't say a thing - he just stood there blinking."
كما أعرب الدكتور لي عن قلقه إزاء التقارير التي تفيد بأن الأطفال في تركيا قد أصيبوا الآن بفيروس إنفلونزا الطيور (A(H5N1 دون أن يمرضوا.	Dr. Lee also expressed his concern about reports that children in Turkey have now become infected with the A(H5N1) avian influenza virus without becoming ill.
أشار إلى أن بعض الدراسات تشير إلى أن المرض يجب أن يصبح أقل فتكًا قبل أن يتمكن من التسبب في وباء عالمي.	Some studies suggest that the disease must become less lethal before it can cause a global epidemic, he noted.
وهناك مخاوف من أن يستمر المرضى في إصابة المزيد من الناس بالعدوى من خلال العمل الروتيني اليومي إذا ظلت أعراض الإنفلونزا معتدلة.	There is concern that patients may continue to infect more people by going through their daily routines if the flu symptoms remain mild.
قم بالحصول على نسخٍ من السياسة الخاصة بك وتفاصيل الاتصال الخاصة بشركة التأمين واحملها معك.	Make and carry copies of your policy and your insurer's contact details with you.
يجب عليهم إظهار عنوان البريد الإلكتروني الخاص بالمؤمّن وأرقام الهاتف الدولية للحصول على المشورة/التفويضات وتقديم الدعاوي.	They need to show the insurer's e-mail address and international phone numbers for advice/authorizations and making claims.
احتفظ بنسخة أخرى في أمتعتك وعبر الإنترنت (أرسل لنفسك بريدًا إلكترونيًا بمرفق أو خزنه على "السحابة").	Have another copy in your luggage and online (e-mail to yourself with attachment, or stored in the "cloud").
في حال كنت مسافرًا ومصطحبا جهاز كمبيوتر محمول أو جهاز لوحي رفقتك، فقم بتخزين نسخة إما في ذاكرته أو في قرصه (يمكن الوصول إليها بدون الإنترنت).	If traveling with a laptop or tablet, store a copy in its memory or disc (accessible without the internet).
بالإضافة إلى ذلك قدّم نسخاً من السياسة/جهات الاتصال لرفاق السفر والأقارب أو الأصدقاء في الوطن المستعدين للمساعدة.	Also give policy/contact copies to traveling companions and relatives or friends back home willing to help.
بينما يبدو أن هناك لقاحاً واحداً تجريبياً قادراً على الحد من وفيات الإيبولا، حتى الآن، لم يتم إثبات أي عقاقير مناسبة لعلاج العدوى الموجودة.	While one experimental vaccine appears able to reduce Ebola mortality, up until now, no drugs have been clearly demonstrated suitable for treating existing infection.
كان كوكتيل واحد من الأجسام المضادة، وهو ZMapp، واعداً في البداية في هذا المجال، ولكن الدراسات الرسمية أشارت إلى أن الفائدة المترتبة على هذا الكوكتيل كانت أقل من الفوائد التي تم السعي إليها في منع الموت.	One antibody cocktail, ZMapp, initially showed promise in the field, but formal studies indicated it had less benefit than sought in preventing death.
في تجربة PALM، استُخدم عقار ZMapp كمعيار مراقبة، بمعنى أن العلماء وضعوه كأساس وقارنوا العلاجات الثلاثة الأخرى به.	In the PALM trial, ZMapp served as a control, meaning scientists used it as a baseline and compared the three other treatments to it.
اكتشفَ د. توني مول مرضَ السّل شديد المقاومةِ للأدويةِ أو ما بعرف ب (XDR-TB) في منطقةِ كوازولوناتال في جنوب إفريقيا.	Dr. Tony Moll discovered the Extremely Drug Resistant Tuberculosis (XDR-TB) in the South African region KwaZulu-Natal.
لقد قال في مقابلة أن شكل البكتيريا المتغير الجديد "مثير للقلق ومروّع للغاية بسبب معدل الوفيات المرتفع جداً."	In an interview, he said the new variant was "very highly troubling and alarming because of the very high fatality rate."
يعتقد د. مول أن بعض المرضى من بينهم اثنين من العاملين بالمستشفى يحتمل أن يكونوا قد أصيبوا بالفيروس داخل المستشفى.	Some patients might have contracted the bug in the hospital, Dr. Moll thinks, and at least two were hospital health workers.
خلال عام واحد، قد يصيب الشخص المُصاب ما بين 10 إلى 15 من المختلطين القرباء.	In one year's time, an infected person may infect 10 to 15 close contacts.
مع ذلك، فإن النسبة المئوية لمرض السلّ شديد المقاومة للأدوية في إجمالي مجموعة المصابين بالسلّ ما تزال مُنخفضة؛ حيث يُصاب 6000 من إجمالي 330000 شخص في أي لحظة محددة بجنوب إفريقيا.	However, the percentage of XDR-TB in the entire group of people with tuberculosis still seems to be low; 6,000 of the total 330,000 people infected at any particular moment in South Africa.
تم الإعلان عن أول حالات المرض هذا الموسم في نهاية شهر تموز.	The first cases of the disease this season were reported in late July.
يتم نقل المرض من خلال الخنازير، والذي ينتقل بعد ذلك إلى البشر من خلال البعوض.	The disease is carried by pigs, which then migrates to humans through mosquitos.
حضّ انتشار الوباء الحكومة الهندية على أن تتخذ إجراءات كنشر من يصطاد الخنازير في المناطق المصابة بشدة وكذلك أن توزع آلاف من ستائر البعوض وأن ترش مبيدات حشرية.	The outbreak has prompted the Indian government to undertake such measures as deployment of pig catchers in seriously affected areas, distributing thousands of mosquito curtains and spraying pesticides.
ووعدت الحكومة بتوفير عدة ملايين من قنينات لقاح التهاب الدماغ، مما سيساعد في استعداد الوكالات الصحية للعام القادم.	Several million vials of encephalitis vaccine have also been promised by the government, which will help prepare health agencies for next year.
تم تأجيل خطط توصيل اللقاحات إلى المناطق الأكثر تضرراً على مر التاريخ هذا العام بسبب نقص التمويل وتحديد أولوية منخفضة للمرض بالنسبة للأمراض الأخرى.	Plans for vaccines to be delivered to the historically most affected areas this year were delayed due to lack of funds and low prioritisation relative to other diseases.
كتب فلوك أن محاولات البعض للطغيان على النساء ليتوقفوا عن الحديث عن صحة النساء باءت بالفشل.	Fluke wrote that the efforts by some to drown out women from speaking out about women’s health were unsuccessful.
لقد توصلتْ إلى هذا الاستنتاج بسبب كثرة التعليقات الإيجابية والتشجيعات التي أر سلها لها إناث وذكور يشجعون اعتبار أدوية منع الحمل ضرورة طبية.	She came to this conclusion due to the multitude of positive comments and encouragement sent to her by both female and male individuals urging that contraception medication be considered a medical necessity.
أعربت منظمة "مانجولا" الخيرية الطبية ومنظمة أطباء بلا حدود ومنظمة الصحة العالمية، إن هذا هو أسوأ تفشٍ مسجل في البلاد.	The medical charity Mangola, Medecines Sans Frontieres and the World Health Organisation say it is the worst outbreak recorded in the country.
قال المتحدث باسم منظمة أطباء بلا حدود "ريتشارد فيرمان": "تتجه أنغولا نحو تفشي هو الأسوأ على الإطلاق ولا يزال الوضع سيئاً للغاية في أنغولا".	Spokesman for Medecines Sans Frontiere Richard Veerman said: "Angola is heading for its worst ever outbreak and the situation remains very bad in Angola," he said.
تأكد إصابة بطة برية نافقة بسلالة إنفلونزا الطيور القاتلة للإنسان، H5N1، وقد عثر عليها يوم الاثنين، في مستنقعات بالقرب من ليون في شرق فرنسا.	The strain of bird flu lethal to humans, H5N1, has been confirmed to have infected a dead wild duck, found on Monday, in marshland near Lyon in the east of France.
فرنسا هي البلد السابع ضمن الاتحاد الأوروبي الذي يعاني من هذا الفيروس؛ بعد النمسا وألمانيا وسلوفينيا وبلغاريا واليونان وإيطاليا.	France is the seventh country in the European Union to suffer this virus; following Austria, Germany, Slovenia, Bulgaria, Greece and Italy.
وتبقى الحالات المشتبه في إصابتها بفيروس H5N1 في كرواتيا والدنمارك غير مؤكدة.	Suspected cases of H5N1 in Croatia and Denmark remain unconfirmed.
أكد هاميلتون أن مستشفى جامعة هوارد استقبل المريض في حالة مستقرة.	Hamilton confirmed Howard University Hospital admitted the patient in stable condition.
لقد زار المريض نيجيريا حيث سُجلت بعض حالات الإصابة بفيروس إيبولا.	The patient had been to Nigeria, where some cases of the Ebola virus have occurred.
اتبعت المستشفى بروتوكول مكافحة العدوى، بما في ذلك فصل المريض عن الآخرين لمنع انتقال العدوى المحتملة للآخرين.	The hospital has followed protocol for infection control, including separating the patient from others to prevent possible infection of others.
