بسبب حرارة النهار، قد يرى المسافرون السراب الذي يوهم بوجود الماء (أو أشياء أخرى).	In the heat of the day, travelers can experience mirages that give the illusion of water (or other things).
قد تكون هذه خطيرة إذا سعى المسافر وراء السراب، وأهدر الطاقة الثمينة والمياه المتبقية.	These can be dangerous if the traveler pursue the mirage, wasting precious energy and remaining water.
وحتى أشد الصحاري حرارة قد تصبح باردة للغاية في الليل. يعتبر انخفاض حرارة الجسم خطراً حقيقياً بدون ارتداء ملابس دافئة.	Even the hottest of deserts can become extremely cold at night. Hypothermia is a real risk without warm clothing.
في الصيف خاصة، يجب عليكم الانتباه من البعوض إن قررتم تسلق الجبال في الغابات المطيرة.	In summer, especially, you'll need to watch out for mosquitoes if you decide to hike through the rainforest.
حتى إذا كنت تقود سيارتك عبر الغابات المطرية شبه الاستوائية، فإن فتح الأبواب لبضع ثوانٍ أثناء دخولك إلى السيارة يشكل وقتاً كافياً للبعوض للدخول إلى السيارة معك.	Even if you're driving through the subtropical rainforest, a few seconds with the doors open while you get inside the vehicle is enough time for mosquitoes to get in the vehicle with you.
يمكن أن تصيب إنفلونزا الطيور، أو الإنفلونزا المتعلقة بالطيور بشكلٍِ أكثر رسمية، الطيور والثدييات.	Bird flu, or more formally avian influenza, can infect both birds and mammals.
فقد تم الإبلاغ عن أقل من ألف حالة ضمن البشر، لكن بعضها كان قاتلاً.	Fewer than a thousand cases have ever been reported in humans, but some of them have been fatal.
شارك معظم الأشخاص الذين يعملون في قطاع الدواجن، ولكن هناك أيضًا بعض المخاطر على مراقبي الطيور.	Most have involved people who work with poultry, but there is also some risk to birdwatchers.
تتميز دولة "النرويج" عادةً بوجود المضايق والوديان شديدة الانحدار، حيث تفسح فجأة الطريق أمام هضبة عالية، أو هضاب أعلى أو أكثر انخفاضاً.	Typical for Norway are steep fjords and valleys that suddenly give way to a high, more or less even plateau.
غالباً ما يشار إلى هذه الهضاب باسم "vidde"، أي مساحة واسعة ومفتوحة وغير محدودة بلا أشجار.	These plateaus are often referred to as "vidde" meaning a wide, open treeless space, a boundless expanse.
في روغالاند وأجدر عادة ما يُطلق عليهم "هاي" بمعنى المستنقعات الخالية من الأشجار التي غالباً ما تكون مغطاة بالخلنج.	In Rogaland and Agder they are usually called "hei" meaning a treeless moorland often covered in heather.
الأنهار الجليدية ليست مستقرة، ولكنها تتدفق أسفل الجبل مما يؤدي إلى حدوث تشققات وصدوع عميقة قد تحجبها الجسور الجليدية.	The glaciers are not stable, but flow down the mountain. This will cause cracks, crevasses, which may be obscured by snow bridges.
يمكن أن تنهار جدران وسقوف الكهوف الجليدية ويمكن أن تنغلق شقوقها.	The walls and roofs of ice caves can collapse and cracks can get closed.
تنفصل كتل ضخمة عند حواف الأنهار الجليدية فتسقط أو ربما تقفز أو تتدحرج بعيدًا عن الحافة.	At the edge of glaciers huge blocks break loose, fall down and perhaps jump or roll farther from the edge.
يبلغ موسم السياحة في محطات التلال ذروته عامةً أثناء الصيف الهندي.	The tourist season for the hill stations generally peaks during the Indian summer.
مع ذلك، فهم يتمتعون بنوع مختلف من الجمال والسحر خلال الشتاء، حيث تسقط على العديد من محطات التلال كميات كبيرة من الثلج وتقيم أنشطة كالتزحلق والتزلج على الجليد.	However, they have a different kind of beauty and charm during winter, with many hill stations receiving healthy amounts of snow and offering activities such as skiing and snowboarding.
عادة ما تكون مراصد ما قبل الحداثة مهملة اليوم، وتبقى كمتاحف أو مواقع تعليمية.	Pre-modern observatories are usually obsolete today, and remain as museums, or sites of education.
بينما لم يكن التلوث الضوئي في ذروته إحدى مشاكلهم المهمة كما هي الحال في هذه الأيام، فهم متواجدون عادة في المدن أو حرم الجامعات والوصول إليهم أسهل من الوصول إلى تلك المبنية في العصر الحديث.	As light pollution in their heyday was not the kind of problem it is today, they are usually located in cities or at campuses, easier to reach than those built in modern times.
معظمُ تلسكوباتِ البحوثِ الحديثة هي منشآتٌ هائلةٌ في المناطق النائيّة ذات الظّروف الجويّة الملائمة.	Most modern research telescopes are enormous facilities in remote areas with favorable atmospheric conditions.
تعتبر مشاهدة أزهار الكرز-المعروفة باسم هانامي- جزءاً من الثقافة اليابانية منذ القرن الثامن.	Cherry blossom viewing, known as hanami, has been a part of Japanese culture since the 8th century.
جاء المفهوم من الصين حيث كانت أزهار البرقوق هي الأكثر رواجًا.	The concept came from China where plum blossoms were the flower of choice.
في اليابان، قام الإمبراطور بتنظيم أولى حفلات أزهار الكرز حصراً لنفسه ولأعضاء آخرين من الطبقة النبيلة حول البلاط الإمبراطور.	In Japan, the first cherry blossom parties were hosted by the emperor only for himself and other members of the aristocracy around the Imperial Court.
تكون النباتات في أفضل أحوالها حينما تظل في بيئة طبيعية، لذا قاوم رغبتك في القطف حتى ولو كانت عينة "واحدة فقط".	Plants look their best when in a natural environment, so resist the temptation to remove even "just one" specimen.
عند زيارة حديقة منسقة بشكل رسمي، فإن جمع "العينات" سيؤدي أيضاً إلى طردك، دون مناقشة.	If visiting a formally arranged garden, collecting "specimens" is also going to get you ejected, without discussion.
وعموماً تعتبر دولة سنغافورة مكاناً آمناً جداً ويسهل التنقّل فيه للغاية، وحيث يمكنك شراء أي شيءٍ تقريباً بعد الوصول.	Singapore is generally an extremely safe place to be and very easy to navigate, and you can buy almost anything after arriving.
بسبب موقعها "القريب من المناطق الاستوائية" ببضع درجات فقط شمال الخط الاستوائي، فأنتم بحاجة للتعامل مع كلاهما: الحرارة العالية المستمرة والشمس اللافحة (وذلك نادراً عندما تكون السماء صافية).	But being placed in the "high tropics" just a few degrees north of equator you will need to deal with both heat (always) and strong sun (when the sky is clear, more rarely).
هناك أيضاً عدد قليل من الحافلات المتجهة شمالاً إلى مدينة الخليل، وهي مكان الدفن التقليدي لآباء الكتاب المقدس "إبراهيم" و"إسحاق" و"يعقوب" وزوجاتهم.	There are also a few buses going north to Hebron, the traditional burial place of the Biblical patriarchs Abraham, Isaac, Jacob, and their wives.
تأكد من أن الحافلة التي تفكر في أن تقلها تذهب إلى الخليل وليس فقط إلى مستوطنة كريات أربع اليهودية القريبة.	Check that the bus you are thinking of taking goes into Hebron and not just to the nearby Jewish settlement of Kiryat Arba.
يمكن أن تمثل الترع المائية الداخلية فكرة جيدة لإقامة عطلة حولها.	Inland waterways can be a good theme to base a holiday around.
فعلى سبيل المثال زيارة القلاع في وادي لوار أو وادي الراين أو القيام برحلة بحرية إلى مدن مثيرة للاهتمام على نهر الدانوب أو ركوب الزوارق على طول قناة إيري.	For example visiting castles in the Loire Valley, the Rhine valley or taking a cruise to interesting cites on the Danube or boating along the Erie Canal.
وتحدد الممرات المائية الداخلية أيضاً الطرق الشائعة للسفر على الأقدام وركوب الدراجات.	They also define routes for popular hiking and cycling trails.
لقد أتت جميع الحيوانات التي وصلت في الأصل إلى الجزر إما بالسباحة أو بالطيران أو بالطفو.	All animals that originally arrived in the islands came here either by swimming, flying or floating.
ونظراً لبعد المسافة عن القارة، لم تتمكن الثدييات من القيام بالرحلة، مما جعل السلحفاة العملاقة حيوان الرعي الأساسي في جزر جالاباغوس.	Due to the long distance from the continent mammals were unable to make the journey making the giant tortoise the primary grazing animal in the Galapagos.
منذ وصول الإنسان إلى غالاباغوس، تم تقديم العديد من الثدييات بما في ذلك الماعز والخيول والأبقار والجرذان والقطط والكلاب.	Since the arrival of man to the Galapagos, many mammals have been introduced including goats, horses, cows, rats, cats and dogs.
إذا قررت زيارة منطقة القطب الشمالي أو القطب الجنوبي في الشتاء، فسوف تجرب الليل القطبي، وهو يعني أن الشمس لا ترتفع فوق الأفق.	If you visit the Arctic or Antarctic areas in the winter you will experience the polar night, which means that the sun doesn't rise above the horizon.
يُوفّر ذلك فرصةً جيدةً لمشاهدةِ الشفقِ القطبيِّ ، حيث ستكون السماء مظلمةً بصورةٍ أكثر أو أقل على مدار الساعة.	This offers a good opportunity to see the Aurora borealis, as the sky will be dark more or less around the clock.
بما أن المناطق مأهولة قليلاً والتلوث الضوئي على الأغلب ليس مشكلة، فسوف تتمكن أيضاً من الاستمتاع بمراقبة بالنجوم.	As the areas are sparsely populated, and light pollution therefore often not a problem, you will also be able to enjoy the stars.
