بفضل روابط كابلات الألياف الضوئية الموجودة تحت سطح البحر إلى أوروبا والأقمار الصناعية ذات النطاق العريض، فإن غرينلاند لديها اتصال جيد بالإنترنت حيث 93٪ من السكان لديهم اتصال بالإنترنت.	Thanks to undersea fiber optic cable links to Europe and broadband satellite, Greenland is well connected with 93% of the population having internet access.
غالباً ما سيكون عند فندقك أو مضيفيك (إذا كنت ستنزل بدار ضيافة أو منزل خاص) شبكة wifi أو كمبيوتر متصل بالإنترنت، وجميع التجمعات فيها مقهى إنترنت أو موقع مخصص به شبكة wifi عامة.	Your hotel or hosts (if staying in a guesthouse or private home) will likely have wifi or an internet connected PC, and all settlements have an internet cafe or some location with public wifi.
كما هو مذكور أعلاه، على الرغم من أن كلمة "إسكيمو" ما زالت مقبولة في أمريكا، فإنها تعتبر تحقيراً من قِبل العديد من سكان القطب الشمالي غير الأمريكيين وخاصةً في كندا.	As mentioned above, though the word "Eskimo" remains acceptable in the United States, it is considered pejorative by many non-U.S. Arctic peoples, especially in Canada.
بالرغم من استخدام سكان جرينلاند الأصليين كلمة إسكيمو، فلا يجب أن يستخدمها الأجانب.	While you may hear the word used by Greenlandic Natives, its use should be avoided by foreigners.
يُطلق السكان الأصليون لغرينلاند على أنفسهم اسم الإنويت في كندا وكلاليك (مفرد كالاليت)، من سكان غرينلاند في غرينلاند.	The native inhabitants of Greenland call themselves Inuit in Canada and Kalaalleq (plural Kalaallit), a Greenlander, in Greenland.
الجريمة، وسوء النية تجاه الأجانب بشكل عام غير معروفة في الواقع في جرينلاند. حتى في المدن لا يوجد "مناطق خطر".	Crime, and ill-will toward foreigners in general, is virtually unknown in Greenland. Even in the towns, there are no "rough areas."
قد يكون المناخ البارد هو الخطر الحقيقي الوحيد الذي سوف يواجهه الأشخاص غير المستعدين له.	Cold weather is perhaps the only real danger the unprepared will face.
إذا قررت زيارة غرينلاند خلال المواسم الباردة (مع الأخذ بعين الاعتبار أنك كلما توجهت شمالاً أصبح الجو أكثر برودة)، فمن الضروري إحضار ملابس دافئة.	If you visit Greenland during cold seasons (considering that the further north you go, the colder it will be), it is essential to bring warm enough clothing.
يمكن أن تؤدي الأيام الطويلة جدًا في الصيف إلى مشاكل في الحصول على قسط كافٍ من النوم والمشكلات الصحية المرتبطة.	The very long days in the summer can lead to problems getting sufficient sleep and associated health issues.
خلال فصل الصيف، احذروا من البعوض النوردي فرغم أنه لا ينقل أي أمراض، إلا أن قد يكون مزعجًا.	During the summer, also watch out for the Nordic mosquitoes. Although they do not transmit any diseases, they can be irritating.
يرتبط اقتصاد مدينة سان فرانسسكو بأنها منطقة جذب سياحي عالمية إلا أنه اقتصاد متنوع.	While San Francisco's economy is linked to it being a world-class tourist attraction, its economy is diversified.
أكبر قطاعات العمل هي الخدمات المهنيّة، والقطاع الحكومي، والماليّة، والتجارة، والسياحة.	The largest employment sectors are professional services, government, finance, trade, and tourism.
ساعد ظهورها المدينة في الموسيقى والأفلام والأدب والثقافة الشعبية على جعلها علامة مميزة معروفة حول العالم.	Its frequent portrayal in music, films, literature and popular culture has helped make the city and its landmarks known throughout the world.
طورت سان فرانسيسكو بنيةً تحتيةً سياحيةً كبيرةً مع العديد من الفنادق والمطاعم ومرافق المؤتمرات من الطراز الأوّلِ.	San Francisco has developed a large tourist infrastructure with numerous hotels, restaurants, and top-notch convention facilities.
تعد سان فرانسيسكو أيضاً واحدة من أفضل الأماكن في البلاد لمأكولات المطابخ الآسيوية الأخرى: الكورية والتايلاندية والهندية واليابانية.	San Francisco is also one of the best places in the nation for other Asian cuisine: Korean, Thai, Indian, and Japanese.
يعد السفر إلى عالم "والت ديزني" رحلة رئيسية مقدسة للعديد من العائلات الأمريكية.	Traveling to Walt Disney World represents a major pilgrimage for many American families.
تتضمن الزيارة "التقليدية" السفر إلى مطار أورلاندو الدولي، والانتقال إلى أحد فنادق ديزني في الموقع، وقضاء حوالي أسبوع دون مغادرة ملكية ديزني والعودة إلى الوطن.	The "typical" visit involves flying into Orlando International Airport, busing to an on-site Disney hotel, spending about a week without leaving Disney property, and returning home.
مع وجود عدد لا نهائي من الاختلافات ممكنة، لا يزال هذا ما يعنيه معظم الناس عندما يتحدثون عن "الذهاب إلى عالم ديزني".	There are infinite variations possible, but this remains what most people mean when they talk of "going to Disney World".
تُستخدم العديد من التذاكر، التي تُباع عبر الإنترنت من خلال مواقع المزادات مثل eBay أو Craiglist، جزئياً كتذاكر دخول متعددة الأيام لأكثر من حديقة.	Many tickets sold online through auction websites such as eBay or Craigslist are partially used multi-day park-hopper tickets.
علي الرغم من أنة نشاط شائع جداً، إلا أنة ديزني تحظره : التذاكر غير قابلة للتحويل.	While this is a very common activity, it is prohibited by Disney: the tickets are non-transferable.
يتطلب أي مخيم أسفل الحافة في غراند كانيون تصريحاً للتخييم الليلي.	Any camping below the rim in Grand Canyon requires a backcountry permit.
تقتصر التصاريح على حماية الوادي، وتكون متاحة في اليوم الأول من الشهر، قبل أربعة أشهر من شهر البدء.	Permits are limited to protect the canyon, and become available on the 1st day of the month, four months prior to the start month.
وبالتالي، أي تصريح دخول للريف الخلفي بأي تاريخ بدء في مايو، يصبح متاحاً في 1 يناير.	Thus, a backcountry permit for any start date in May becomes available on 1 Jan.
تُملأ عموماً مساحة المناطق الأكثر شعبية، مثل برايت إنجل كامب غراوند المجاورة لـفانطوم رانتش، بالطلبات الواردة في التاريخ الأول، والتي يتم فتحها للحجز.	Space for the most popular areas, such as the Bright Angel Campground adjacent to Phantom Ranch, generally fill up by the requests received on first date they are opened to reservations.
يتوافر عدد تصاريح محدود مخصص للطلبات المقدمة حضوراً بأسبقية التقديم.	There are a limited number permits reserved for walk-in requests available on a first come, first served basis.
الدخول إلى جنوب أفريقيا بالسّيارة هو طريقةٌ رائعةٌ لمشاهدة كل جمال المنطقة بالإضافة إلى الوصول إلى الأماكن خارج الطرق السياحية المعتادة.	Entering Southern Africa by car is an amazing way to see all the region's beauty as well as to get to places off the normal tourist routes.
ويمكن القيام بذلك باستخدام سيارة عادية مع التخطيط الدقيق ولكن ينصح باستخدام نظام الدفع الرباعي 4x4 بدرجة كبيرة، ويمكن الوصول إلى العديد من المواقع باستخدام نظام الدفع الرباعي المزود بقاعدة عجلات عالية فقط.	This can be done in a normal car with careful planning but a 4x4 is highly advised and many locations are only accessible with a high wheel base 4x4.
ضع في اعتبارك أثناء التخطيط أنه على الرغم من أن جنوب أفريقيا مستقرة، لكن ليست جميع البلدان المجاورة كذلك.	Keep in mind while planning that although Southern Africa is stable not all neighboring countries are.
تتفاوت متطلبات التأشيرات وتكاليفها باختلاف الدول، وتتأثر أيضاً تلك المتطلبات بالدولة الآتي منها.	Visa requirements and costs vary from nation to nation and are affected by the country you come from.
لكل بلدٍ قوانينه الخاصة المتعلقة بأغراض الطوارئ التي يجب أن تتواجد في السيارة.	Each country also has unique laws requiring what emergency items need to be in the car.
شلالات فيكتوريا هي مدينة تقع في الجزء الغربي من زيمبابوي، عبر الحدود من ليفينغستون، وزامبيا، وبالقرب من بوتسوانا.	Victoria Falls is a town in the western portion of Zimbabwe, across the border from Livingstone, Zambia, and near Botswana.
تقع المدينة بجانب الشلالات مباشرةً، وهم أكبر معالمها جاذبية، لكن هذه الوجهة السياحية تقدم للباحثين عن المغامرة والمتفرجين على المعالم العديد من الفرص من أجل إقامة أطول.	The town lies immediately next to the falls, and they are the major attraction, but this popular tourist destination offers both adventure seekers and sightseers plenty of opportunities for a longer stay.
في موسم الأمطار (من نوفمبر إلى مارس)، سيرتفع منسوب المياه وستكون الشلالات أكثر إثارة.	In the rainy season (November to March), the water volume will be higher and the Falls will be more dramatic.
ستبتل ملابسك بكل تأكيد إذا عبرت الجسر أو تمشيت على طول الطرق الملتوية بالقرب من شلالات فيكتوريا.	You are guaranteed to get wet if you cross the bridge or walk along the trails winding near the Falls.
ومن الناحية الأخرى، يحدث هذا تحديدًا لأن حجم الماء مرتفع للغاية بحيث يحجب رؤيتك للشلالات الفعلية لكثرة المياه!	On the other hand, it is precisely because the volume of water is so high that your viewing of the actual Falls will be obscured—by all the water!
مقبرة توت عنخ آمون (KV62). ربما تكون أشهر مقابر وادي الملوك، مشهد اكتشاف هوارد كارتر سنة 1922 للمقبرة الملكية للملك في حالة شبه كاملة.	Tomb of Tutankhamun (KV62). KV62 may be the most famous of the tombs in the Valley, the scene of Howard Carter's 1922 discovery of the almost intact royal burial of the young king.
بالمقارنة مع معظم المقابر الملكية الأخرى، فإن مقبرة توت عنخ آمون بالكاد تستحق الزيارة، لكونها أصغر بكثير وذات زخارف محدودة.	Compared to most of the other royal tombs, however, the tomb of Tutankhamun is barely worth visiting, being much smaller and with limited decoration.
وكل من يرغب في رؤية أدلة على الضرر الذي لحق بالمومياء أثناء محاولات إزالتها من النعش سوف يخيب أمله لأنه يمكن رؤية الرأس والكتفين فقط	Anyone interested in seeing evidence of the damage to the mummy done during attempts to remove it from the coffin will be disappointed as only the head and shoulders are visible.
لم تعد الثروات الرائعة للمعبد موجودة بداخله، لكن تم إزالتها إلى المتحف المصري بالقاهرة.	The fabulous riches of the tomb are no longer in it, but have been removed to the Egyptian Museum in Cairo.
يُفضل أن يقضي الزوّار محدودو الوقت وقتَهم في مكان آخر.	Visitors with limited time would be best to spend their time elsewhere.
فنوم كروم، على بعد 12 كيلومتر من مدينة سيام ريب. بُنى هذا المعبد الموجود على قمة التل في نهاية القرن التاسع أثناء فترة حكم الملك ياسوفرمان.	Phnom Krom, 12 km southwest of Siem Reap. This hilltop temple was built at the end of the 9th century, during the reign of King Yasovarman.
الأجواء المعتمة حول المعبد وإطلالته على بحيرة "تونلي ساب" تعطي قيمة للتسلق إلى التل.	The gloomy atmosphere of the temple and the view over the Tonle Sap lake make the climb to the hill worthwhile.
يمكن الجمع بين زيارة الموقع بشكل مناسب مع رحلة بالقارب إلى البحيرة.	A visit to the site can be conveniently combined with a boat trip to the lake.
تصريح أنغكور مطلوب لدخول المعبد لذلك لا تنس أن تحضر جواز سفرك معك عندما تتجه إلى تونلي ساب.	The Angkor Pass is needed to enter the temple so do not forget to bring your passport along when heading to Tonle Sap.
القدس عاصمة إسرائيل وأكبر مدنها رغم أن معظم الدول الأخرى والأمم المتحدة لا تعترف بها عاصمة لها.	Jerusalem is the capital and largest city of Israel, though most other countries and the United Nations do not recognize it as Israel's capital.
المدينة القديمة في تلال يهودا لديها تاريخ مذهل على امتداد آلاف السنين.	The ancient city in the Judean Hills has a fascinating history spanning thousands of years.
المدينة مقدسة للأديان السماوية الثلاث - اليهودية، والمسيحية، والإسلام، وهي بمنزلة مركز روحي، وديني، وثقافي.	The city is holy to the three monotheistic religions - Judaism, Christianity and Islam, and serves as a spiritual, religious, and cultural center.
ونظراً للأهمية الدينية للمدينة، لا سيما المواقع العديدة في منطقة البلدة القديمة، فإن القدس واحدة من الوجهات السياحية الرئيسية في فلسطين المحتلة.	Due to the religious significance of the city, and in particular the many sites of the Old City area, Jerusalem is one of the main tourist destinations in Israel.
تضم القدس العديد من المواقع التاريخية، والأثرية، والثقافية، إلى جانب مراكز التسوق، والمقاهي، والمطاعم الحيوية والمزدحمة.	Jerusalem has many historic, archeological and cultural sites, along with vibrant and crowded shopping centers, cafés, and restaurants.
وتشترط دولة الإكوادور أن يتلقى المواطنون الكوبيون رسالة دعوةٍ قبل دخولهم دولة الإكوادور عن طريق المطارات الدوليّة أو نقاط الدخول الحدوديّة.	Ecuador requires that Cuban citizens receive an invitation letter prior to entering Ecuador through international airports or frontier admission points.
يجب تصديق هذا الخطاب من قبل وزارةِ الخارجيةِ الإكوادورية، وتوافقه مع متطلباتٍ معينة.	This letter must be legalized by the Ecuadorian Ministry of Foreign Affairs, and comply with certain requirements.
تم نشأة هذه المتطلبات لتوفير تدفق هجرةٍ مُنظمٍ بين البلدين.	These requirements are designed to provide an organized migratory flow between both countries.
يجب على المواطنين الكوبيين الحاملين لبطاقة الإقامة الأمريكية الدائمة زيارة مقر قنصلية الإكوادور للحصول على إعفاء من هذا الشرط.	Cuban citizens who are US green card holders should visit an Ecuadorian Consulate to obtain an exemption to this requirement.
لا بد أن يكون جواز السفر الخاص بك سارياً على الأقل لمدة 6 شهور بعد تواريخ السفر الخاصة بك. سنحتاج إلى تذكرة ذهاب وعودة لإثبات مدة إقامتك.	Your passport must be valid for at least 6 months beyond your travel dates. A round/onward trip ticket is needed to prove the length of your stay.
إذا كنت بمفردك أو مع صديق واحد فقط، حاول أن تقابل أشخاصاً آخرين وأن تشكل مجموعة من أربعة إلى ستة أفراد لكي تحصل على سعر أفضل للفرد، ذلك لأن الجولات السياحية أرخص للمجموعات الأكبر عدداً.	Tours are cheaper for larger groups, so if you're by yourself or with just one friend, try to meet other people and form a group of four to six for a better per-person rate.
ومع ذلك، لا ينبغي أن يكون هذا خارج شواغلك، لأنه غالباً ما يتم تغيير أماكن السياح لملء السيارات.	However, this shouldn't really be off your concern, because often tourists are shuffled around to fill the cars.
يبدو الأمر في الواقع وكأنه طريقة لخداع الناس لكي يعتقدوا بأنه يجب عليهم دفع المزيد.	It seems actually to be more a way of tricking people into believing they have to pay more.
الجبل المرتفع فوق الطرف الشمالي من ماتشو بيتشو هو هذا الجبل شديد الانحدار، وغالباً ما يكون خلفية للعديد من صور الآثار.	Towering above the north end of Machu Picchu is this steep mountain, often the backdrop to many photos of the ruins.
يبدو الأمر شاقاً بعض الشيء من الأسفل، وهو صعود شديد الانحدار وصعب، ولكن معظم الأشخاص الذين يتمتعون بلياقة معقولة يجب أن يكونوا قادرين على الوصول في غضون 45 دقيقة.	It looks a bit daunting from below, and it is a steep and difficult ascent, but most reasonably fit persons should be able to make it in about 45 minutes.
يتم وضع السّلالم الحجريّة بامتداد معظم المسار، وتوفّر الكابلات الفولاذية في الأقسام الأكثر انحداراً متكأً داعماً.	Stone steps are laid along most of the path, and in the steeper sections steel cables provide a supporting handrail.
مع ذلك، توقع أن تنقطع أنفاسك، وتوخَّ الحذر في الأجزاء الأكثر انحداراً، خاصةً عندما تكون مبتلة، حيث يمكن أن تصبح سريعة بشكل خطير.	That said, expect to be out of breath, and take care in the steeper portions, especially when wet, as it can become dangerous quickly.
يوجد كهف ضئيل بالقرب من القمة يجب المرور خلاله، إنه منخفض جداً وضيّق إلى حد كبير.	There's a tiny cave near the top that must be passed through, it is quite low and a rather tight squeeze.
أفضل طريقة لمشاهدة المواقع والحياة البرية في جزر غالاباغوس بالقارب، بالضبط كما فعل تشارلز داروين في عام 1835.	Seeing the sites and wildlife of the Galapagos is best done by boat, just as Charles Darwin did it in 1835.
تجوب أكثر من 60 سفينة سياحية مياه جالاباجوس تحمل كل منها ما بين 8 إلى 100 راكب.	Over 60 cruise ships ply the Galapagos waters - ranging in size from 8 to 100 passengers.
يحجز معظم الناس أماكنهم مسبقاً في وقتٍ مبكرٍ (لأن القوارب عادةً ما تكون ممتلئةً خلال موسم الذروة).	Most people book their place well in advance (as the boats are usually full during the high season).
قم بالتأكد من أن الوكيل الذي سوف تحجز عن طريقه متخصص في جزر جالاباجوس ولديه معرفةٌ واسعةٌ بمجموعاتٍ متنوعةٍ من السفن.	Be sure the agent through whom you book is a Galapagos specialist with a good knowledge of a wide variety of ships.
سيعمل هذا على ضمان أن تكون السفينة ملائمة لاهتماماتك و/أو قيودك التي تحددها.	This will ensure that your particular interests and/or constraints are matched with the ship most suitable to them.
قبل وصول الإسبان في القرن السادس عشر، كان شمال تشيلي تحت حكم الإنكا، بينما كان سكان أروكانيا الأصليون (مابوتشي) يسكنون وسط وجنوب تشيلي.	Before the Spanish arrived in the 16th century, northern Chile was under Inca rule while the indigenous Araucanians (Mapuche) inhabited central and southern Chile.
كانت "المابوتشي" أيضاً واحدة من آخر مجموعات السكان الأصليين الأمريكية المستقلة، والتي لم يتم تقبلها بالكامل في الحكم الناطق بالإسبانية حتى بعد استقلال دولة "تشيلي".	The Mapuche were also one of the last independent American indigenous groups, that were not fully absorbed into Spanish-speaking rule until after Chile's independence.
مع أنّ دولة تشيلي قد أعلنت استقلالها سنة 1810 (في خضم حروب نابليون التي تركت إسبانيا بدون حكومة مركزية فاعلة لمدة سنتين)، غير أن النصر الحاسم على الإسبان لم يتحقق حتى سنة 1818.	Although Chile declared independence in 1810 (amid the Napoleonic wars that left Spain without a functioning central government for a couple of years), decisive victory over the Spanish was not achieved until 1818.
جمهورية الدومينيكان (بأسبانية: ريبوبليكا الدومينيكان) هي البلد الكاريبي التي تحتل النصف الشرقي من جزيرة هيسبانيولا، التي تشترك مع هايتي.	The Dominican Republic (Spanish: República Dominicana) is a Caribbean country that occupies the eastern half of the island of Hispaniola, which it shares with Haiti
بجانب الشواطئ ذات الرمال البيضاء والمناظر الطبيعية الجبلية، تعد البلاد موطنًا لأقدم مدينة أوروبية في الأمريكتين، وهي الآن جزء من سانتو دومينغو.	Besides white sand beaches and mountain landscapes, the country is home to the oldest European city in the Americas, now part of Santo Domingo.
كان يسكن تلك الجزيرة لأول مرة شعب التاينو والكاريبي. حيث كان الكاريبيون من الأشخاص الناطقين باللغة الآراواكانية، والذين وصلوا حوالي عام ١٠٠٠٠ قبل الميلاد.	The island was first inhabited by the Taínos and Caribes. The Caribes were an Arawakan-speaking people who had arrived around 10,000 BCE.
خفض الغزاة الأسبان تعداد سكان التاينو بصورة كبيرة خلال بضع سنين قصيرة من وصول المستكشفين الأوروبيين.	Within a few short years following the arrival of European explorers, the population of Tainos had significantly been reduced by the Spanish conquerors
وفقًا للراهب بارتولومي دي لاس كاساس (معاهدة جزر الهند)، قتل الغزاة الإسبان حوالي 100,000 من شعب التاينوس ما بين عام 1492 و1498.	Based on Fray Bartolomé de las Casas (Tratado de las Indias) between 1492 and 1498 the Spanish conquerors killed around 100,000 Taínos.
حديقة الاتحاد. بُنيت لتكون بهوًا لدير من القرن السابع عشر، يعتبر معبد سان دييجو المبنى الوحيد المتبقي منه.	Jardín de la Unión. This space was built as the atrium for a 17th-century convent, of which the Templo de San Diego is the sole surviving building.
تعمل الآن كساحة مركزية، ودائماً ما يقام فيها الكثير من الأحداث ليلاً ونهاراً.	It now functions as the central plaza, and always has a lot of things going on, day and night.
يوجد عددٌ من المطاعم المحيطة بالحديقة، وغالباً ما تُقام حفلاتٌ موسيقيةٌ مجانية ٌمن الشرفة المركزية في فترات بعد الظهر والمساء.	There are a number of restaurants surrounding the garden, and in the afternoons and evening there free concerts are often given from the central gazebo.
Callejon del Beso (زقاق القبلة). شرفتان تفصل بينهما 69 سم فقط، عبارة عن موطن لأسطورة حب قديمة.	Callejon del Beso (Alley of the Kiss). Two balconies separated by only 69 centimeters is home of an old love legend.
سيخبرك بعض الأطفال القصة مقابل قروش قليلة.	For a few pennies some children will tell you the story.
إن الرحلة إلى جزيرة باون هى رحلة نهارية مشهورة أو رحلة نهاية أسبوع توفر الكاياك والمشي والمتاجر والمطاعم والمزيد.	Bowen Island is a popular day trip or weekend excursion offering kayaking, hiking, shops, restaurants, and more.
ويقع هذا المجتمع الأصلى فى هاو ساوند بالقرب من مدينة فانكوفر، ويسهل الوصول إليه عبر التاكسى المائى المحجوز مسبقًا الذي يُقلع من جزيرة جرانفيل فى وسط مدينة فانكوفر.	This authentic community is located in Howe Sound just off Vancouver, and is easily accessed via scheduled water taxis departing Granville Island in downtown Vancouver.
الرحلة إلى ممر Sea to Sky أساسيّة لمن يستمتعون بالأنشطة الخارجية.	For those who enjoy outdoor activities, a trek up the Sea to Sky corridor is essential.
بلدية ويسلر (الواقعة على بعد ساعة ونصف بالسيارة من فانكوفر) غالية الثمن، ولكن معروفة بسبب دورة الألعاب الأولمبية الشتوية لعام 2010.	Whistler (1.5 hour drive from Vancouver) is expensive but well-known because of the 2010 Winter Olympics.
في الشتاء، استمتع بأفضل تجارب التزلّج في أمريكا الشماليّة، وفي الصيف، جرّب ركوب الدرّاجات الجبليّة الأصيل.	In the winter, enjoy some of the best skiing in North America, and in the summer try some authentic mountain biking.
يجب حجز التصاريح مقدماً. يجب أن تحصل على تصريح لقضاء الليل في سيرينا.	Permits must be reserved in advance. You must have a permit to stay overnight at Sirena.
تعد سيرينا محطّة الحرس الوحيدة التي تقدّم السّكن في صالة نوم مشتركة ووجبات ساخنة بالإضافة إلى التّخييم. تقدّم محطّات لا ليونا وسان بيدريللو ولوس باتوس التّخييم فقط بدون خدمة طعام.	Sirena is the only ranger station that offers dormitory lodging and hot meals in addition to camping. La Leona, San Pedrillo, and Los Patos offer only camping with no food service.
يمكن الحصول على تصاريح المنتزه مباشرة من محطة رانجر في بويترو خمينز، لكن لا يقبلون بطاقات الائتمان.	It is possible to secure park permits directly from the Ranger Station in Puerto Jiménez, but they do not accept credit cards
لا تُصدر خدمة المنتزه (ميناي) تصاريح دخول المنتزه قبل أكثر من شهر من الوصول المتوقع.	The Park Service (MINAE) does not issue park permits more than one month in advance of anticipated arrival.
يقدم مقهى CafeNet El Sol خدمة حجز مقابل رسوم بقيمة 30 دولاراً أمريكياً أو 10 دولارات أمريكية مقابل تذاكر ليوم واحد فقط؛ التفاصيل على صفحة Corcovado.	CafeNet El Sol offers a reservation service for a fee of US$30, or $10 for one-day passes; details on their Corcovado page.
جزر كوك هي دولة جزرية مرتبطة بشكل حر بنيوزيلندا، وتقع في بولينيزيا وسط جنوب المحيط الهادئ.	The Cook Islands are an island country in free association with New Zealand, located in Polynesia, in the middle of the South Pacific Ocean.
إنه أرخبيل يضم 15 جزيرة منتشرة على مساحة تزيد عن 2.2 مليون كيلومتر مربع من المحيط.	It is an archipelago with 15 islands spread out over 2.2 million km2 of ocean.
مع نفس المنطقة الزمنية مثل هاواي، يُنظر أحياناً إلى الجزر علي أنها "هاواي أسفل".	With the same time zone as Hawaii, the islands are sometimes thought of as "Hawaii down under".
على الرغم من كونها أصغر حجماً، فإنها تذكّر بعض الزائرين القدامى القادمين بهاواي ما قبل قيام الدولة قبل وجود كل الفنادق السياحية الكبيرة وغيرها من التطويرات.	Though smaller, it reminds some elderly visitors of Hawaii before statehood without all the large tourist hotels and other development.
لا يوجد في جزر كوك أي مدن ولكنها تتكون من 15 جزيرة أهمها راروتونجا وإيتوتاكي.	The Cook Islands do not have any cities but are composed of 15 different islands. The main ones are Rarotonga and Aitutaki.
في البلدان المتقدمة اليوم، تم رفع مستوى المبيت والإفطار الفاخر إلى شكل فني.	In developed countries today, providing deluxe bed and breakfasts has been raised to a sort of art-form.
في النهاية لا يخفى تنافس موفري الأسِرَّة والإفطار على شيئين أساسيين هما الأسِرَّة والإفطار.	At the top end, B&Bs obviously compete mainly on two main things: bedding and breakfast.
وبناءً على ذلك، تجد في أرقى هذه المؤسّسات أفخر أغطية للأسرّة، وربما لحافاً مصنوعاً يدويّاً أو سريراً عتيق الطّراز.	Accordingly, at the finest such establishments one is apt to find the most luxurious bedding, maybe a handmade quilt or an antique bed.
يمكن أن تشمل وجبة الإفطار المأكولات الموسمية في المنطقة أو طبق خاص للمضيف.	Breakfast may include seasonal delights of the region or the host's speciality dish.
رُبما المكان عبارة عن مبنى تاريخي قديم مع أثاث عتيق وأراضٍ مشذبة وحمام سباحةٍ.	The setting might be an historic old building with antique furnishings, manicured grounds and a swimming pool.
لركوب سيارتك الخاصة والانطلاق بها في رحلة طويلة جاذبية ذاتية تكمن في بساطة الأمر.	Getting into your own car and heading off on a long road trip has an intrinsic appeal in its simplicity.
على عكس المركبات الكبيرة، ربما تكون على درايةٍ بالفعل بقيادة سيارتك ومعرفة حدودها.	Unlike larger vehicles, you are probably already familiar with driving your car and know its limitations.
قد يؤدي نصب خيمة في ملكية خاصة أو في مدينة بأي حجم إلى جذب انتباه غير مرغوب فيه بسهولة.	Setting up a tent on private property or in a town of any size can easily attract unwanted attention.
باختصار، سيارتك وسيلة رائعة للقيام برحلة برية، ولكن نادراً ما تكون في حد ذاتها وسيلة "للتخييم".	In short, using your car is a great way to take a road trip but seldom in itself a way to "camp".
يمكنك التخييم في السّيارة إذا كنت تمتلك ميني فان كبيرة أو سيارة دفعٍ رباعي أو سيدان أو ستيشن واغن بمقاعد يمكن طيّها.	Car camping is possible if you have a large minivan, SUV, Sedan or Station Wagon with seats that lay down.
بعض الفنادق لها تراث من العصر الذهبي للقطارات البخارية والبواخر التي تسير في خطوط منتظمة؛ وذلك قبل الحرب العالمية الثانية، في القرن التاسع عشر أو أوائل القرن العشرين.	Some hotels have a heritage from the golden age of steam railways and ocean liners; before the Second World War, in the 19th or early 20th centuries.
كانت هذه الفنادق هي المكان الذي سيقيم فيه الأثرياء والمشاهير في حينه، وغالبًا ما كان لديهم طعام جيد وحياة ليلية.	These hotels were where the rich and the famous of the day would stay, and often had fine dining and nightlife.
تمثّل تركيبات الأثاث قديمة الطراز وعدم توافر وسائل الراحة الحديثة وجمال الطراز العتيق سمة مميزة لطابعها.	The old fashioned fittings, the lack of the latest amenities, and a certain graceful agedness are also part of their character.
في حين أنها عادة ما تكون مملوكة ملكية خاصة ، إلا أنها تستوعب رؤساء الدول الزائرين أحياناً وغيرهم من الشخصيات البارزة.	While they are usually privately owned, they sometimes accommodate visiting heads of state and other dignitaries.
قد يفكر المسافر الذي يملك الكثير من الأموال في القيام برحلة حول العالم مع إقامات متقطعة في عدد من هذه الفنادق.	A traveller with piles of money might consider a round the world flight, broken up with stays in many of these hotels.
تمثل شبكة تبادل الضيافة منظمة تربط المسافرين بالسكان المحليين في المدن التي سيزورونها.	A hospitality exchange network is the organization that connects travelers with locals in the cities they are going to visit.
عادة ما يتطلب الانضمام إلى هكذا شبكة إكمال نموذج عبر الإنترنت رغم أن بعض الشبكات تعرض أو تطلب تحققًا إضافيًا.	Joining such a network usually just requires filling out an online form; although some networks offer or require additional verification.
تُقدم بعد ذلك قائمة بالمستضيفين المتوفيين سواء مطبوعةً و/أو عبر الإنترنت، أحياناً تشمل مراجع وتقييمات من مسافرين آخرين.	A listing of available hosts is then provided either in print and/or online, sometimes with references and reviews by other travelers.
تم إطلاق منصة Couchsurfing في يناير 2004 عندما لم تتمكن المبرمجة كاسي فينتون من إيجاد مكان للإقامة في أيسلندا بعد إيجاد رحلة طيران رخيصة إلى هناك.	Couchsurfing was founded in January 2004 after computer programmer Casey Fenton found a cheap flight to Iceland but did not have a place to stay.
أرسل رسائل إلكترونية إلى التلاميذ في الجامعة المحلية واستلم عددًا هائلاً من عروض السكن المجاني.	He emailed students at the local university and received an overwhelming number of offers for free accommodation.
تلبي الأنزال حاجات الشباب - فضيفها المعتاد في العشرينيات من عمره - ولكن غالباً ما تجد مسافرين أكبر سناً هناك أيضاً.	Hostels cater primarily to young people – a typical guest is in their twenties – but you can often find older travellers there too.
من النادر أن ترى عائلات لديهم أطفال، لكن تسمح بعض نُزل الشباب بهم في الغرف الخاصة.	Families with children are a rare sight, but some hostels do allow them in private rooms.
سوف تستضيف مدينة بكين في الصين الألعاب الأولمبية الشتوية في عام 2022، وهو ما يجعلها أول مدينة تستضيف كل من الألعاب الأولمبية الصيفية والشتوية.	The city of Beijing in China will be the host city of the Olympic Winter Games in 2022, which will make it the first city to have hosted both the summer and winter Olympics.
تستضيف مدينة بكين مراسم الافتتاح والاختتام وفعاليات الجليد الداخلية.	Beijing will host the opening and closing ceremonies and the indoor ice events.
كما ستقام أحداث تزلج أخرى في منطقة "تايزيتشنغ" للتزلج في "زانغجياكو"، على بعد ما يقارب 220 كيلومتراً (140 ميلا) من بكين.	Other skiing events will be at the Taizicheng ski area in Zhangjiakou, about 220 km (140 miles) from Beijing.
لدى مُعظم المعابد مهرجانٌ سنويٌ يبدأ من نهاية تشرين الثاني وحتى منتصف أيار، والذي يختلف وفقاً للتقويم السنوي لكل معبد.	Most of the temples do have an Annual festival starting from November end to Mid of May, which varies according to each temple's annual calendar.
يتم الاحتفال بمعظم مهرجانات المعبد كجزء من الذكرى السنوية للمعبد أو عيد ميلاد الإله أو أي حدث كبير آخر مرتبط بالمعبد.	Most of the temple festivals is celebrated as part of temple's anniversary or presiding deity's birthday or any other major event associated with the temple.
مهرجانات معبد كيرالا مثيرة للمشاهدة بشكل كبير، مع موكب منظم من الفيلة المزينة، أوركسترا المعابد والاحتفالات الأخرى.	Kerala's temple festivals are very interesting to see, with regular procession of decorated elephants, temple orchestra and other festivities.
إن المعرض العالمي (المعروف باسم معرض العالم، أو ببساطة المعرض) عبارة عن مهرجان دولي ضخم للفنون والعلوم.	A World's Fair (commonly called World Exposition, or simply Expo) is large international festival of arts and sciences.
تقدم البلدان المشاركة عروضاً فنية وتعليمية في السرادق الوطنية لتسليط الضوء على القضايا العالمية أو ثقافة بلادهم وتاريخها.	Participating countries present artistic and educational displays in national pavilions to showcase world issues or their country's culture and history.
المعارض البستانية الدولية هي أحداث متخصصة في عرض الأزهار والحدائق النباتية وأي شيء آخر له علاقة بالنباتات.	International Horticultural Expositions are specialised events which showcase floral displays, botanical gardens and anything else to do with plants.
مع أنه، نظرياً، يمكن إقامتهم سنوياً (طالما كانوا في بلدان مختلفة)، إلا أن هذا لا يحدث عملياً.	Although in theory they can take place annually (so long as they are in different countries), in practice they are not.
تستمر هذه الفعاليات عادة ما بين ثلاثة وستة أشهر، وتقام في مواقع لا تقل مساحتها عن 50 هكتارًا.	These events normally last anywhere between three and six months, and are held on sites no smaller than 50 hectares.
تعد الحياة البرية من بين أكثر الصور تحدياً بالنسبة للمصور الفوتوغرافي، فهي تحتاج إلى مزيج من الحظ السعيد، والصبر، والخبرة، والمعدات الجيدة.	Wildlife is among the most challenging motifs for a photographer, and needs a combination of good luck, patience, experience and good equipment.
غالبًا ما يتم اعتبار تصوير الحياة البرية أمراً مسلماً به، ولكن مثل التصوير الفوتوغرافي بشكل عام، فإن الصورة تساوي ألف كلمة.	Wildlife photography is often taken for granted, but like photography in general, a picture is worth a thousand words.
غالبًا ما يتطلب تصوير الحياة البرية عدسة تليفوتوجرافي طويلة، على الرغم من أن أشياء مثل سرب من الطيور أو مخلوق صغير تحتاج إلى عدسات أخرى.	Wildlife photography often requires a long telephoto lens, though things like a flock of birds or a tiny creature need other lenses.
من الصعب أن نجد العديد من الحيوانات الغريبة، وفي بعض الأحيان قد تكون للحدائق العامة قواعد خاصة بشأن التقاط الصور الفوتوغرافية لأغراض تجارية.	Many exotic animals are hard to find, and parks sometimes have rules about taking photographs for commercial purposes.
قد تكون الحيوانات البرية إما خجولة أو عدوانية. قد تكون البيئة باردة، أو ساخنة، أو معادية.	Wild animals might either be shy or aggressive. The environment might be cold, hot, or otherwise hostile.
يتواجد في العالم أكثر من 5000 لغة مختلفة، بما في ذلك أكثر من عشرين لغة مع 50 مليون متحدث أو يزيد.	The world has over 5,000 different languages, including more than twenty with 50 million or more speakers.
غالباً ما تكون الكلمات المكتوبة أسهل في الفهم من الكلمات المنطوقة، أيضاً. هذا ينطبق بشكل خاص بالعناوين، والتي يكون غالباً يصعب نطقها بشكل واضح.	Written words are often easier to understand than spoken words, also. This is especially true of addresses, which are often difficult to pronounce intelligibly.
العديد من الدول بأكملها تتحدث الإنكليزية بطلاقةٍ، وفي دول أكثر من ذلك بكثيرٍ، يمكنك أن تتوقع معرفةً محدودةً - وخاصةً بين الشباب.	Many entire nations are completely fluent in English, and in even more you can expect a limited knowledge - especially among younger people.
تخيّل، إن صح التعبي، رجلاً مانكوني وبوسطناني وجامايكي وسيدنيسايدر جالسين حول طاولة يتناولون العشاء في مطعم في تورونتو.	Imagine, if you will, a Mancunian, Bostonian, Jamaican and Sydneysider sitting around a table having dinner at a restaurant in Toronto.
فهم يمتعون بعضهم البعض بقصص من محل نشأتهم، تُحكى من خلال لهجاتهم المميزة ولغتهم المحلية.	They're regaling each other with stories from their hometowns, told in their distinct accents and local argot.
هناك العديد من الأشياء التي يجب أن تأخذها في الاعتبار قبل وأثناء سفرك إلى مكان ما.	There are many things you have to take into consideration before and when you travel somewhere.
تختلف الآداب، والقوانين، والطعام، والمرور، والسكن، والمعايير، واللغة وما إلى ذلك إلى حد ما عن المكان الذي تعيش فيه، لذلك فعندما تسافر، لا تتوقع أن تكون الأمور كما هي في "الوطن".	When you travel, expect things not to be like they are "back home". Manners, laws, food, traffic, lodging, standards, language and so on will to some extent differ from where you live.
هذا شيء تحتاج دائمًا إلى وضعه في الاعتبار، لتجنب خيبة الأمل أو ربما حتى النفور من الطرق المحلية للقيام بالأشياء.	This is something you always need to keep in mind, to avoid disappointment or perhaps even distaste over local ways to do things.
كانت وكالات السفر موجودة منذ القرن التاسع عشر . عادة ما يكون وكيل السفر خيارًا جيدًا لرحلة تتجاوز خبرة المسافر السابقة في الطبيعة، أو الثقافة، أو اللغة أو البلدان منخفضة الدخل.	Travel agencies have been around since the 19th century. A travel agent is usually a good option for a journey which extends beyond a traveller's previous experience of nature, culture, language or low-income countries.
على الرغم من أن أغلب الوكالات مستعدة للاضطلاع بمعظم الحجوزات المنتظمة، فإن العديد من الوكلاء يختصون في أنواع أو ميزانيات أو وجهات محددة للسفر.	Although most agencies are willing to take on most regular bookings, many agents specialise in particular types of travel, budget ranges or destinations.
قد يكون من الأفضل استخدام وكيل يقوم في كثيرٍ من الأحيان بحجز رحلاتٍ مشابهةٍ لرحلاتك.	It can be better to use an agent who frequently books similar trips to yours.
ألقِ نظرة على الرحلات التي يقوم الوكيل بترويجها، سواءً كان ذلك على موقع إلكتروني أو في نافذة متجر.	Take a look at what trips the agent is promoting, whether on a website or in a shop window.
إذا أردت السفر بثمن بخس، للضرورة، أو كنمط حياة أو كتحدٍ، فهناك بعض الطرق للقيام بذلك.	If you want to see the world on the cheap, for necessity, lifestyle or challenge, there are some ways to do that.
ينقسمان في الأساس إلى قسمين: إما أن تعمل أثناء السفر أو أن تحاول الحد من مصاريفك. تُركز هذه المقالة على القسم الثاني.	Basically, they fall into two categories: Either work while you travel or try and limit your expenses. This article is focused on the latter.
لمن لديهم استعداد للتضحية بالراحة والوقت ومعرفة المتوقّع، من أجل تخفيض المصاريف إلى ما يقارب الصفر، تعرّف على السفر بأقل ميزانية.	For those willing to sacrifice comfort, time and predictability to push expenses down close to zero, see minimum budget travel.
تفترض النصيحة أن المسافرين لا يسرقون، ولا يتعدون، أو يشاركون في السوق غير القانونية، ولا يشحذون، أو يستغلون الآخرين لصالح منفعتهم الخاصة.	The advice assumes that travellers do not steal, trespass, participate in the illegal market, beg, or otherwise exploit other people for their own gain.
عادة ما تكون نقطة تفتيش الهجرة هي المحطة الأولى عند النزول من طائرة أو سفينة أو مركبة أخرى.	An immigration checkpoint is usually the first stop when disembarking from a plane, a ship, or another vehicle.
في بعض القطارات العابرة للحدود تحصل تفتيشات على القطار المتحرك ويجب أن يكون لديكم هوية شخصية صالحة حين صعودكم إحدى هذه القطارات.	In some cross-border trains inspections are done on the running train and you should have valid ID with you when boarding one of those trains.
في قطارات النوم الليلية، يمكن أن يتم جمع جوازات السفر بواسطة المحصل حتى لا ينقطع نومك.	On night sleeper trains, passports may be collected by the conductor so that you do not have your sleep interrupted.
يُعَد التسجيل مطلب إضافي لعملية التأشيرة، ففي بعض البلدان يجب عليك تسجيل حضورك وعنوانك لدى السلطات المحلية حيث تقيم.	Registration is an additional requirement for the visa process. In some countries, you must register your presence and address where you are staying with the local authorities.
قدْ يتطلّب ذلك مِلء استمارة لدى الشرطة المحلية أو زيارة مكاتبَ الهجرة.	This might require filling out a form with the local police or a visit to the immigration offices.
في كثيرٍ من البلدان التي يوجد فيها مثل هذا القانون، تتولّى الفنادق المحلية مهمّة التسجيل (تأكد من الاستفسار عن ذلك).	In many countries with such a law, local hotels will handle the registration (make sure to ask).
في حالات أخرى، لا يحتاج إلى التسجيل إلا من يقيمون خارج أماكن الإقامة السياحية. ومع ذلك، فإن هذا يجعل القانون أكثر غموضاً، لذا اعرف مقدماً.	In other cases, only those staying outside of tourist accommodations need to register.  However, this makes the law much more obscure, so find out beforehand.
تعنى العمارة بتصميم المباني وتشييدها. فالهندسة المعمارية لمكان ما هي في الغالب مزار سياحي في حد ذاته.	Architecture is concerned with the design and construction of buildings. The architecture of a place is often a tourist attraction in its own right.
العديد من المبانى جميلةٌ إلى حدٍ ما ويمكن أن يكون المنظر من مبنى طويل أو من نافذةٍ ذات موقع ذكي أمرًا رائعاً للنظر.	Many buildings are quite beautiful to look at and the view from a tall building or from a cleverly-positioned window can be a beauty to behold.
يوجد تداخل كبير ما بين الهندسة والمجالات الأخرى وتشمل التخطيط الحضري والهندسة المدنية والفنون الزخرفية والتصميم الداخلي وتصميم المناظر الطبيعية.	Architecture overlaps considerably with other fields including urban planning, civil engineering, decorative arts, interior design and landscape design.
نظراً لبُعد العديد من قرى البويبلو، فلن تحظى بفرصة كبيرة للحياة الليلية دون السفر إلى ألباكركي أو سانتا فيه.	Given how remote many of the pueblos are, you won't be able to find a significant amount of nightlife without traveling to Albuquerque or Santa Fe.
مع ذلك، فكل الكازينوهات المذكورة في اللائحة أعلاه تقريباً تقدم مشروبات، ومعظمها يجلب ترفيهاً يحمل علامات تجارية (وبالأساس تلك الكبيرة منها والتي تحيط بألبوكويرك وسانتا في مباشرةً).	However, nearly all of the casinos listed above serve drinks, and several of them bring in name-brand entertainment (primarily the large ones immediately surrounding Albuquerque and Santa Fe).
كن حذراً: حانات البلدات الصغيرة في هذه المنطقة ليست دوماً أماكن جيّدة للزائر من خارج الولاية لتمضية الوقت فيها.	Beware: small-town bars here are not always good places for the out-of-state visitor to hang out.
السبب الأول هو معاناة شمال نيو مكسيكو من مشاكل كبيرة في القيادة تحت تأثير الكحول، كما أن كثافة السائقين المخمورين مرتفعة بالقرب من حانات المدن الصغيرة.	For one thing, northern New Mexico has significant problems with drunk driving, and the concentration of intoxicated drivers is high close to small-town bars.
يطلق على اللوحات الجدارية أو الخربشات غير المرغوبة مصطلح الجرافيتي.	Unwanted murals or scribble is known as graffiti.
بالرغم من كونها ظاهرة غير حديثة على الإطلاق، فإن أغلب الناس يربطون بينها وبين تخريب الشباب للممتلكات العامة والخاصة باستخدام بخاخ الطلاء.	While it's far from a modern phenomenon, most people probably associate it with youth vandalizing public and private property using spray paint.
مع ذلك، ففي الوقت الراهن هناك فنانون متمكنون للرسم على الجدران، كما أن هناك فعاليات للكتابة على الجدران وكذلك الجدران القانونية. وفي هذا السياق غالبا ما تشبه لوحات الكتابة على الجدران أعمال فنية أكثر مما تشبه علامات غير مفهومة.	However, nowadays there are established graffiti artists, graffiti events and "legal" walls. Graffiti paintings in this context often resemble artworks rather than illegible tags.
يعتبر رمي البوميرانغ مهارةً شائعةً يرغب الكثير من السيّاح اكتسابها.	Boomerang throwing is a popular skill that many tourists want to acquire.
إذا كنت تريد أن تتعلم رمي الخشبة المرتدة التي تعود إلى يدك بعد رميها، فتأكد من أن لديك الخشبة المناسبة لكي تعود لك.	If you want to learn throwing a boomerang that comes back to your hand, make sure you have a suitable boomerang for returning.
معظم "بوميرانج" المتاحة في أستراليا لا ترجع في الواقع. من الأفضل للمبتدئين عدم محاولة رميها في الرياح القوية.	Most boomerangs available in Australia are in fact non-returning. It is best for beginners to not try throwing in windy
تُطهى "وجبة هانجي" في حفرة ساخنة في الأرض.	A Hangi Meal is cooked in a hot pit in the ground.
تسخّن الحفرة إما بالحجارة المسخنة من النار، أو في بعض الأماكن تجعل الطاقة الحرارية الأرضية مناطق من الأرض ساخنةً بشكل طبيعي.	The pit is either heated with hot stones from a fire, or in some places geothermal heat makes areas of ground naturally hot.
غالباً ما يتم استخدام "الهانجى" لطهي عشاء تقليدي مشوي.	The hangi is often used to cook a traditional roast style dinner.
تقدم عدة أماكن في روتوروا وجبة الهانجي المطهية بسخونة الأرض بينما يمكن تذوق وجبات هانجي أخرى في كرايستشيرش وويلنجتون وأماكن أخرى.	Several places in Rotorua offer geothermal hangi, while other hangi can be sampled in Christchurch, Wellington and elsewhere.
تحتوي خدمة مترو ريل على درجتين في قطارات المسافرين من وحول مدينة كيب تاون: مترو بلس (تُدعى أيضًا الدرجة الأولي) ومترو (تُدعى الدرجة الثالثة).	MetroRail has two classes on commuter trains in and around Cape Town: MetroPlus (also called First Class) and Metro (called Third Class).
درجة متروبلس أكثر راحة وأقل ازدحامًا لكنها أغلى رغم أنها تظل أرخص من تذاكر المترو العادية في أوروبا.	MetroPlus is more comfortable and less crowded but slightly more expensive, though still cheaper than normal metro tickets in Europe.
يحتوي كل قطار على عربات الدرجة الأولى والدرجة الثالثة؛ تكون عربات الدرجة الأولى دائماً في نهاية القطار الأقرب لمدينة كيب تاون.	Every train has both MetroPlus and Metro coaches; the MetroPlus coaches are always on the end of the train nearest Cape Town.
الحمل للآخرين - لا تدع حقائبك بعيداً عن عينيك، خاصة عندما تعبر الحدود الدولية.	Carrying for others - Never let your bags out of your sight, especially when you are crossing international borders.
قد تكتشف أنه يتم استغلالك لنقل المخدرات دون أن تعلم، وهو ما يضعك في متاعبٍ جمة.	You could find yourself being used as a drug carrier without your knowledge, which will land you in a great deal of trouble.
وهذا يشمل الانتظار في الطابور، حيث يمكن استخدام كلاب شم المخدرات في أي وقت دون سابق إنذار.	This includes waiting in line, as drug-sniffing dogs could be used at any time without notice.
تُطبق بعض البلدان عقوبات شديدة القسوة حتى فيما يتعلق بالجرائم المرتكبة لأول مرة؛ حيث قد تشمل تلك العقوبات أحكام بالسجن لأكثر من 10 سنوات أو الإعدام.	Some countries have exceedingly draconian punishments even for first time offenses; these can include prison sentences of over 10 years or death.
تعد الحقائب المهملة هدفاً للسرقة، كما يمكن أن تلفت إنتباه السلطات القلقة من القنابل.	Unattended bags are a target for theft and can also attract attention from authorities wary of bomb threats.
بسبب هذا التعرض المستمر للجراثيم المحلية في الوطن، فإن الاحتمالات أنك محصن ضدها بالفعل مرتفعة للغاية.	At home, due to this constant exposure to the local germs, odds are very high that you're already immune to them.
لكن في أجزاء أخرى من العالم فيما تكون الحيوانات الجرثومية جديدة عليك، فهنالك احتمال كبير جداً أن تقع في مشكلات.	But in other parts of the world, where the bacteriological fauna are new to you, you're far more likely to run into problems.
كما أنه في الأجواء الأكثر حرارةً تنمو الجراثيم بسرعةٍ أكبر وتعيش لفترات أطول خارج الجسم.	Also, in warmer climates bacteria both grow more quickly and survive longer outside the body.
وبالتالي آفات دلهي بيلي ولعنة الفراعنة وانتقام مونتيزوما، وأصدقاؤهم الكثيرون.	Thus the scourges of Delhi Belly, the Pharaoh's Curse, Montezuma's Revenge, and their many friends.
كما هو الحال مع مشاكل الجهاز التنفسي في المناخات الباردة، فإن المشاكل المعوية في المناخات الحارة شائعة إلى حد ما وفي معظم الحالات تكون مزعجة بشكل واضح ولكنها ليست شديدة الخطورة.	As with respiratory problems in colder climates, intestinal problems in hot climates are fairly common and in most cases are distinctly annoying but not really dangerous.
في حال كنت مسافرًا إلى دولة نامية لأول مرة، أو في مكان جديد من العالم، فلا تقلل من شأن الصدمة الثقافية المحتملة.	If traveling in a developing country for the first time – or in a new part of the world – don't underestimate the potential culture shock.
دُهشَ العديد من المسافرين المستقرين والقادرين من خلال حداثة السفر إلى دول العالم النامي، حيث يمكن تراكم العديد من التعديلات الثقافية الصغيرة بصورةٍ سريعةٍ.	Many a stable, capable traveler has been overcome by the newness of developing world travel, where many little cultural adjustments can add up quickly.
وخاصةً في أيامك الأولى، فكر في الصرف بكثرة على الفنادق بالطراز الغربي وذات الجودة العالية والغذاء والخدمات للمساعدة على التأقلم.	Especially in your initial days, consider splurging on Western-style and -quality hotels, food, and services to help acclimatize.
لا تنم على فرشٍ أو لبادةٍ على الأرض في الأماكن التي لست على دراية فيها بالحيوانات المحلية.	Do not sleep on a mattress or pad on the ground in areas where you do not know the local fauna.
إذا كنت خارجاً للتخييم، أحضر معك سريراً سفرياً أو أرجوحة شبكية لإبعاد الثعابين والعقارب وما إلى ذلك عنك.	If you are going to camp out, bring a camp cot or hammock to keep you away from snakes, scorpions and such.
املأ منزلك بقهوة غنية في الصباح وبعضاً من شاي البابونج المريح في الليل.	Fill your home with a rich coffee in the morning and some relaxing chamomile tea at night.
عندما تكون في عطلة منزلية، يكون لديك وقت كافٍ لتدليل نفسك وقضاء بعضاً من الدقائق الإضافية لتحضير مشروب مميز.	When you're on a staycation, you have the time to treat yourself and take a few extra minutes to brew up something special.
إذا أردت المزيد من المغامرة، فاغتنم الفرصة لتحضير أو مزج بعض السموذي:	If you're feeling more adventurous, take the opportunity to juice or blend up some smoothies:
ربما تكتشف مشروباً بسيطاً يمكنك تحضيره على الإفطار عندما تعود إلى روتينك اليومي.	maybe you'll discover a simple beverage that you can make for breakfast when you're back to your daily routine.
إذا كنت تعيش في مدينة بها ثقافة متنوعة من حيث المشروبات الكحولية، فارتد بارات أو حانات في أحياء لا تتردد فيها.	If you live in a city with a varied drinking culture, go to bars or pubs in neighborhoods you don't frequent.
لغير الملمّين بالمصطلحات الطبّيّة، كلمتا معدٍ وسارٍ لهما معنيان مختلفتان.	For those unfamiliar with medical jargon, the words infectious and contagious have distinct meanings.
إن المرض المعدي هو المرض الذي يسببّه كائن مرضي، مثل الفيروسات أو البكتيريا أو الفطريّات أو الطفيليّات الأخرى.	An infectious disease is one that is caused by a pathogen, such as a virus, bacterium, fungus or other parasites.
المرض المعدي هو مرض يسهل انتقاله بالتواجد في محيط شخصٍ مصابٍ به.	A contagious disease is a disease which is easily transmitted by being in the vicinity of an infected person.
تطالب العديد من الحكومات بتلقيح الزوار الذين يدخلون أو يغادرون دولها ضد مجموعة من الأمراض.	Many governments require visitors entering, or residents leaving, their countries to be vaccinated for a range of diseases.
قد تستند هذه المتطلبات غالباً على البلدان التي زارها المسافر أو التي ينوي الذهاب إليها.	These requirements may often depend on what countries a traveller has visited or intends to visit.
واحدة من نقاط قوة شارلوت، كارولاينا الشمالية، أن لديها غزارة من الخيارات عالية الجودة للعائلات.	One of strong points of Charlotte, North Carolina, is that it has an abundance of high-quality options for families.
غالباً ما يستشهد المقيمون من مناطق أخرى بالودِّ الأسري كسبب أساسي للانتقال إلى هناك، وغالباً ما يجد الزوار سهولة في الاستمتاع بالمدينة مع الأطفال في المكان.	Residents from other areas often cite family-friendliness as a primary reason for moving there, and visitors often find the city easy to enjoy with children around.
خلال الـ20 سنة الماضية، تزايدت الخيارات الملائمة للأطفال في أبتاون شارلوت تصاعديّاً.	In the past 20 years, the amount of child-friendly options in Uptown Charlotte has grown exponentially.
لا تستعمل العائلات سيارات الأجرة عموماً في شارلوت، على الرغم من أنها قد تكون ذات فائدة ما في بعض الظروف.	Taxis are not generally used by families in Charlotte, though they can be of some use in certain circumstances.
هناك رسم إضافي في حالة وجودِ أكثر من مسافرين، لذا قد يكون هذا الخيار أغلى من اللازم.	There is a surcharge for having more than 2 passengers, so this option might be more expensive than necessary.
في هذه الأيام، لا يتم حجز تذاكر السّفر الجوي مباشرةً عبر شركة الطّيران إلّا نادراً من دون البحث عن الأسعار ومقارنتها أولاً.	Nowadays air travel is only rarely booked directly through the airline without first searching and comparing prices.
قد تختلف أسعار رحلة الطيران الواحدة بشكل كبير بين مختلف محركات بحث الرحلات، ومن المفيد مقارنة نتائج البحث وتفقد موقع شركة الطيران نفسها قبل الحجز.	Sometimes the same flight can have vastly differing prices at various agregators and it pays to compare search results and to also look at the website of the airline itself before booking.
ربما تكون مراقبة الجمارك مشكلة، بينما غالباً ما يكون فحص الهجرة غائباً أو إجراءً شكلياً عند وصولك إلى وطنك.	While immigration check is usually absent or a formality when you arrive in your homeland, customs control can be a hassle.
تأكد من أنك تعرف ما يمكنك وما لا يمكنك إحضاره والإعلان عن أي شيء يتجاوز الحدود القانونية.	Make sure you know what you can and cannot bring in and declare anything over the legal limits.
أسهل طريقة للبدء في مجال كتابات السفر هي شحذ المهارات على موقع إلكتروني معتمد للمدوّنات السفريّة.	The easiest way to get started in the business of travel writing is to hone your skills on an established travel blog website.
بعد أن تعتاد التنسيق والتحرير على الويب، يمكنك لاحقاً إنشاء موقعك الخاص.	After you become comfortable with formatting and editing on the web, then later, you might create your own website.
يجب عليك اختيار شركة الخطوط الجوية المنتظمة الخاصة بعناية.	You should choose your Frequent Flyer airline in an alliance carefully.
على الرغم من أنك قد تعتقد أنه من البديهي الانضمام إلى شركة الطيران التي تسافر بواسطتها كثيراً، إلا أنه يجب عليك أن تدرك أن الامتيازات المقدّمة غالبًا ما تكون مختلفة وأن نقاط المسافر الدائم قد تكون أكثر سخاءً مع شركة طيران مختلفةٍ في نفس التحالف.	Although you may think it is intuitive to join the airline you fly most, you should be aware that privileges offered are often different and frequent flyer points may be more generous under a different airline in the same alliance.
خطوط الجوية مثل طيران الإمارات والاتحاد للطيران والخطوط الجوية القطرية قد مدّت خدماتها بشكل إلى أفريقيا، وتوفر رحلات إلى العديد من المدن الإفريقية بأسعار أفضل من الخطوط الجوية الأوروبية.	Airlines such as Emirates, Etihad Airways, Qatar Airways & Turkish Airlines have greatly expanded their services to Africa, and offer connections to many major African cities at competitive rates than other European airlines.
تقدم الخطوط الجوية التركية رحلات طيران إلى 39 وجهة في 30 دولة أفريقية، وذلك اعتباراً من 2014.	Turkish Airlines flies to 39 destinations in 30 African countries as of 2014.
إن كان لديك وقت إضافي خلال السفر، فقارن بين إجمالي سعر أجرة السفر الخاصة بك إلى أفريقيا بالنسبة لأجرة سفرك حول العالم.	If you have additional travel time, check to see how your total fare quote to Africa compares with a round-the-world fare.
تذكّر إضافة التّكاليف الزّائدة للتّأشيرات الإضافيّة وضرائب المغادرة والنّقل البريّ إلخ... من أجل جميع تلك الأماكن التي تقع خارجَ إفريقيا.	Don't forget to add in the extra costs of additional visas, departure taxes, ground transportation, etc. for all those places outside of Africa.
إذا أردت السفر حول العالم بأكمله في نصف الكرة الجنوبي، فإن اختياراتك للرحلات والوجهات ستكون محدودة وذلك بسبب عدم وجود طرق عبر المحيطات.	If you want to fly around the world completely in the Southern Hemisphere, the choice of flights and destinations is limited due to the lack of transoceanic routes.
ولا يشمل أي تحالف لشركات الطيران المعابر الثلاثة على المحيط في نصف الكرة الجنوبي (ولا يغطي سكاي تيم أي من المعابر).	No airline alliance covers all three ocean crossings in the Southern Hemisphere (and SkyTeam covers none of the crossings).
ومع ذلك، فإن تحالف ستار يغطي كل شيء باستثناء شرق جنوب المحيط الهادئ من سانتياغو دي تشيلي إلى تاهيتي، وهي رحلة تابعة لمجموعة خطوط لاتام الجوية التابعة لتحالف عالم واحد.	However, Star Alliance covers everything except the eastern South Pacific from Santiago de Chile to Tahiti, which is a LATAM Oneworld flight.
هذه الرحلة الجوية ليست الخيار الوحيد إذا كنت ترغب في تخطي جنوب المحيط الهادئ والساحل الغربي لأمريكا الجنوبية، (انظر أدناه).	This flight is not the only option if you want to skip the South Pacific and the west coast of South America. (see below)
في عام 1994 شن إقليم ناكورنو كارباخ الاذري، ذو الإثنية الأرمينية، حرباً على الأذريون .	In 1994, the ethnically Armenian Nagorno-Karabakh region of Azerbaijan waged war against the Azeris.
أُنشئت جمهورية جديدة بدعم أرميني، وبالرغم من ذلك، لم تحظ باعتراف رسمي من أي دولة بما في ذلك أرمينيا نفسها.	With Armenian backing, a new republic was created. However, no established nation - not even Armenia - officially recognizes it.
يواصل السجال الدبلوماسي حول المنطقة في توتر العلاقات بين أرمينيا و أذربيجان.	Diplomatic arguments over the region continue to mar relations between Armenia and Azerbaijan.
حي القناة (بالهولندية: Grachtengordel) منطقة شهيرة تعود إلى القرن 17 تحيط بوسط مدينة أمستردام.	The Canal District (Dutch: Grachtengordel) is the famous 17th-century district surrounding the Binnenstad of Amsterdam.
صُنفت المنطقة بأكملها كموقع للتراث العالمي لليونسكو لقيمتها الثقافية والتاريخية الفريدة، وقيم ممتلكاتها من بين أعلى القيم في البلاد.	The whole district is designated as a UNESCO World Heritage Site for its unique cultural and historical value, and its property values are among the highest of the country.
تعني تشينكوي تيري خمسة أراضي وهي تضم خمسة قرى ساحلية صغيرة وهي ريوماغيوري ومانارولا وكورنيغليا وفيرنازا ومونتيروسو التي تقع في منطقة ليغوريا الإيطالية.	Cinque Terre, which means Five Lands, comprises the five small coastal villages of Riomaggiore, Manarola, Corniglia, Vernazza and Monterosso located in the Italian region of Liguria.
وهي مدرجة في قائمة اليونسكو للتراث العالمي.	They are listed on the UNESCO World Heritage List.
على مر القرون، بنى الناس الشرفات بعناية على المناظر الطبيعية الوعرة شديدة الانحدار لتصل بينها وبين المنحدرات المُطلّة على البحر.	Over the centuries, people have carefully built terraces on the rugged, steep landscape right up to the cliffs that overlook the sea.
جزءٌ من جمالها يتلخص في الافتقار إلى التنمية المؤسسية المرئية.و تربط الطرق والقطارات والقوارب القرى مع بعضها ولا تستطيع السيارات الوصول إليها من الخارج.	Part of its charm is the lack of visible corporate development. Paths, trains and boats connect the villages, and cars cannot reach them from the outside.
وخلال رحلته، واجه إيواساكي مشاكل في العديد من المناسبات.	During his trip, Iwasaki ran into trouble on many occasions.
وقد تعرض للسرقة من قبل قراصنة، وهوجم في التبت من قبل كلب مسعور، ونجا من الزواج في نيبال وتم القبض عليه في الهند.	He was robbed by pirates, attacked in Tibet by a rabid dog, escaped marriage in Nepal and was arrested in India.
أوتاوا هي عاصمة كندا الساحرة ثنائية اللغة تضم مجموعة من المعارض الفنية والمتاحف التي تبرز ماضي كندا وحاضرها.	Ottawa is Canada's charming, bilingual capital and features an array of art galleries and museums that showcase Canada's past and present.
تقع شلالات نياجرا في أقصى الجنوب، وفي الشمال يقع بيت الطبيعة الجميلة غير المُستغلة في مسكوكا وما بعدها.	Farther south is Niagara Falls and the north is home to the untapped natural beauty of the Muskoka and beyond.
كل هذه الأشياء وأكثر تسلط الضوء على أنتاريو على أنها ما يُعتبر ذات جوهر كندي من قبل الغرباء.	All these things and more highlight Ontario as what is considered quintessentially Canadian by outsiders.
المناطق الكبيرة في الشمال هي مناطق قليلة السكان نوعا ما والبعض غير مأهول تقريبا.	Large areas further north are quite sparsely populated and some is nearly uninhabited wilderness.
في سبيل المقارنة بين التعداد السكاني التي تدهش الكثيرين: عدد السكان الأمريكان الأفريقيين اللذين يقيمون في الولايات المتحدة الأمريكية أكثر من عدد المواطنين الكنديين.	For a comparison of population that surprises many: There are more African Americans living in the US than there are Canadian citizens.
تقع جزر شرق إفريقيا في المحيط الهندي قبالة الساحلِ الشرقيِّ لأفريقيا.	The East African Islands are in the Indian Ocean off the eastern coast of Africa.
جزيرة إن مدغشقر هي الأكبر على الإطلاق، وهي قارةٌ مستقلةٌ عندما يتعلّق الأمر بالحياةِ البريةِ.	Madagascar is by far the biggest, and a continent on its own when it comes to wildlife.
معظم الجزر الصغيرة هي دول مستقلة، أو مرتبطة بفرنسا، وتعرف باسم المنتجعات الشاطئية الفاخرة.	Most of the smaller islands are independent nations, or associated with France, and known as luxury beach resorts.
حمل العرب الإسلام إلى البلاد، وقد انتشر على مدي نطاق واسع في جزر القمر ومايوت.	The Arabs also brought Islam to the lands, and it took in a big way in the Comoros and Mayotte.
بدأ النفوذ والاستعمار الأوروبي في القرن الخامس عشر، حيث وجد المستكشف البرتغالي فاسكو دا غاما طريق كيب من أوروبا إلى الهند.	European influence and colonialism began in the 15th century, as Portuguese explorer Vasco da Gama found the Cape Route from Europe to India.
من الشمال، يحد الساحل الإفريقي المنطقة، ويحدّها المحيط الأطلسي من الجنوب والغرب.	In the north the region is bounded by the Sahel, and in the south and west by the Atlantic Ocean.
النساء: بغض النظر عن الحالة الاجتماعية الفعلية، ينبغي على النساء المسافرات أن تعلنن إنهن متزوجات.	Women: It is recommended that any women travellers say that they are married, regardless of actual marital status.
إنه من المجدي ارتداء خاتم (لكن ليس الذي يبدو غالياً جداً.	It is helpful to also wear a ring (just not one that looks too expensive.
يجب أن تدرك النساء أن الاختلافات الثقافية قد تؤدي إلى ما قد يعتبرونه تحرشاً وأنه من المعتاد ترصدهم، والإمساك بهم من خلال الذراع، إلخ.	Women should realize that cultural differences may result in what they would consider harassment and it is not uncommon to be followed, grabbed by the arm, etc.
كوني حازمة في رفض الرجال، ولا تخافي من التمسك بموقفك (لا تجعل الاختلافات الثقافية الأمر مقبولاً!).	Be firm in turning down men, and don't be afraid to stand your ground (cultural differences or not, it doesn't make it ok!).
استخدم الفينيقيون والرومان والمرينيد مدينة الدار البيضاء الحديثة كميناء استراتيجي يسمى "أنفا" وذلك بعد تأسيسها على يد الصيادين البربر في القرن العاشر قبل الميلاد.	The modern city of Casablanca was founded by Berber fishermen in the 10th century BCE, and was used by the Phoenicians, Romans, and the Merenids as a strategic port called Anfa.
قام البرتغاليون بتدميرها وإعادة بنائها تحت اسم "كازا برانكا"، فقط ليهجروها بعد زلزال 1755.	The Portuguese destroyed it and rebuilt it under the name Casa Branca, only to abandon it after an earthquake in 1755.
أعاد السلطان المغربي بناء المدينة باسم دارو لبادية، وأطلق التجار الأسبان عليها اسم الدار البيضاء الذين أسسوا قواعد تجارية هناك.	The Moroccan sultan rebuilt the city as Daru l-Badya and it was given the name Casablanca by Spanish traders who established trading bases there.
تعد الدار البيضاء من الأماكن الأقل إثارة للتسوق في كل أنحاء المغرب.	Casablanca is one of the least interesting places to shop in all of Morocco.
يسهل العثور على أماكن لبيع السلع المغربية التقليدية في جميع أنحاء المدينة القديمة، مثل الطواجن والفخار والسلع الجلدية والشيشة وجميع ألوان السلع الرخيصة، ولكن كل هذا مخصص للسياح.	Around the old Medina it's easy to find places selling traditional Moroccan goods, such as tagines, pottery, leather goods, hookahs, and a whole spectrum of geegaws, but it's all for the tourists.
غوما هي مدينة سياحية في جمهورية الكونغو الديمقراطية تقع في أقصى الشرق بالقرب من رواندا.	Goma is a tourist city of the Democratic Republic of Congo in the extreme east near Rwanda.
في سنة 2002 دمرت غوما بسبب حمم بركان نيراجونجو والتي طمرت معظم شوارع المدينة، ومركز المدينة بالخصوص.	In 2002 Goma was destroyed by lava from the Nyiragongo volcano which buried most of the town’s streets, particularly the town centre.
إن أي زيارات خارج "غوما" يجب البحث عنها لفهم حالة القتال المستمر في مقاطعة شمال "كيفو"، في حين أن "غوما" آمنة بشكل معقول.	While Goma is reasonably safe, any visits outside of Goma should be researched to understand the state of the fighting that persists in the North Kivu province.
كما تعد المدينة قاعدة لتسلق بركان نيراجونجو وبعض أرخص سبل تتبع الغوريلا الجبلية في إفريقيا.	The city is also the base to climb the Nyiragongo volcano along with some of the cheapest Mountain Gorilla tracking in Africa.
تستطيع أن تركب البودا بودا (وهي درّاجة نارية تعمل كتاكسي) للتجول في مدينة غوما، والسعر المعتاد (محلياً) حوالي 500 فرنكٍ كونغوليٍ مقابل رحلة قصيرة.	You can use boda-boda (motorcycle taxi) to get around Goma. The normal (local) price is ~500 Congolese Francs for the short ride.
إلى جانب صعوبة الوصول إليها نسبياً، أصبحت "تمبوكتو" تُستخدم كمجاز للأراضي الغريبة البعيدة.	Combined with its relative inaccessibility, "Timbuktu" has come to be used as a metaphor for exotic, distant lands.
تُعد مدينة تمبكتو في وقتنا الحاضر مدينة فقيرة، على الرغم من سمعتها التي تجعلها منطقة جذب سياحي، بالإضافة إلى وجود مطار بها.	Today, Timbuktu is an impoverished town, although its reputation makes it a tourist attraction, and it has an airport.
في سنة 1990، تمت إضافتها إلى لائحة مواقع التراث العالمي المهددة بالخطر، نظراً لتهديد رمال الصحراء.	In 1990, it was added to the list of world heritage sites in danger, due to the threat of desert sands.
كانت إحدى المحطات الرئيسية لهنري لويس غيتس فى مسلسل PBS عن عجائب العالم الأفريقي الخاصة.	It was one of the major stops during Henry Louis Gates' PBS special Wonders of the African World.
تتناقض المدينة بشكل صارخ مع بقية مدن الدولة، لأنها تتميز بطابع عربي أكثر منه إفريقي.	The city is in stark contrast to the rest of the country's cities, because it has more of an Arabic flair than of an African.
يقع منتزه كروغر الوطني (KNP) في شمال شرق جنوب إفريقيا، ويمتد بمحاذاة حدود موزمبيق شرقاً، وزيمبابوي شمالاً، ويحدّه جنوباً نهر كروكودايل.	The Kruger National Park (KNP) lies in the north-east of South Africa and runs along the border of Mozambique in the east, Zimbabwe in the north, and the southern border is the Crocodile River.
تبلغ مساحة المنتزه 19500 كم مربع وهو ينقسم إلى 14 منطقة بيئية مختلفة، يدعم كلّ منها حياةً بريةً مختلفةً.	The park covers 19,500 km² and is divided in 14 different ecozones, each supporting different wildlife.
تُعتبر واحدة من المناطق الجذابة في جنوب إفريقيا كما تعتبر منتزها رئيسياً من المنتزهات الوطنية في جنوب إفريقيا ( منتزهات جنوب إفريقيا الوطنية).	It is one of the main attractions of South Africa and it is considered the flagship of South African National Parks (SANParks).
يوجد رسوم يومية للحفاظ على المنتزه والدخول إليه،أسوة بجميع المتنزهات الوطنية في جنوب إفريقيا.	As with all South African National Parks, there are daily conservation and entry fees for the park.
من الممكن أن يكون مفيداً أن تشتري بطاقة Wild Card، فهي تسمح لك بالدخول إلى مجموعة مختارة من متنزهات جنوب إفريقيا أو جميع متنزهات جنوب إفريقيا الوطنية.	It may also be beneficial for one to buy a Wild Card, which provides entry to either selections of parks in South Africa or all of the South African National Parks.
تمنح جزيرة هونج كونج إقليم هونج كونج اسمه وهي المكان الذي يعتبره العديد من السائحين قبلتهم.	Hong Kong Island gives the territory of Hong Kong its name and is the place that many tourists regard as the main focus.
تشبَّه المباني المصطفة التي ترسم أفق هونج كونج بمخطط بياني برّاق يظهر فوق مياه ميناء فيكتوريا.	The parade of buildings that make the Hong Kong skyline has been likened to a glittering bar chart that is made apparent by the presence of the waters of Victoria Harbour.
لكي تحظى بأفضل المشاهد لهونج كونج، غادر الجزيرة واتجه إلى واجهة كولون البحرية في الجهة المقابلة.	To get the best views of Hong Kong, leave the island and head for the Kowloon waterfront opposite.
الغالبية العظمى من التنمية الحضرية لجزيرة هونج كونج متمركزةٌ بكثافةٍ على أراضٍ مستصلحة على طول الشاطئ الشمالي.	The great majority of Hong Kong Island's urban development is densely packed on reclaimed land along the northern shore.
هذا هو المكان الذي اتّخَذَهُ المستعمرون البريطانيون كمكان خاص بهم، وبالتالي إذا كنت تبحث عن دليلٍ على الماضي الاستعماريِّ للمنطقة، فهذا مكانٌ جيدٌ للبدء.	This is the place the British colonisers took as their own and so if you are looking for evidence of the territory's colonial past, this is a good place to start.
يُعد سونداربانس الحزام الساحلي الأكبر لأشجار القرم في العالم، ويمتد لمسافة 80 كيلومتراً (50 ميلاً) في مناطق بنغلاديش والهند النائية من ناحية الساحل.	The Sundarbans are the largest littoral mangrove belt in the world, stretching 80 km (50 mi) into the Bangladeshi and Indian hinterland from the coast.
أُعلنت سونداربانس موقعاً للتراث العالمي لليونسكو. يُسمى جزء الغابة الموجود داخل الأراضي الهندية بمنتزه سونداربانس الوطني.	The Sundarbans has been declared a UNESCO World Heritage Site. The part of the forest within Indian territory is called Sundarbans National Park.
ولكن الغابات ليست مجرد مستنقعات لأشجار المانجروف؛ فبها بعضٌ من آخر الشواهد القائمة على الأدغال الكثيفة التي غطت في يومٍ ما سهل نهر الغانج.	The forests aren't just mangrove swamps though — they include some of the last remaining stands of the mighty jungles which once covered the Gangetic plain.
تغطي سونداربانس مساحة 3850 كيلومتر مربع، ثلثها تقريباً مغطى بالمياه/المستنقعات.	The Sundarbans cover an area of 3,850 km², of which about one-third is covered in water/marsh areas.
ومنذ عام 1966، كانت سونداربانس محمية للحياة البرية، وتشير التقديرات إلى أن هناك الآن 400 من نمور البنغال الملكية، ونحو 30 ألف غزال منقط في المنطقة.	Since 1966 the Sundarbans have been a wildlife sanctuary, and it is estimated that there are now 400 Royal Bengal tigers and about 30,000 spotted deer in the area.
تغادر الحافلات المحطة الداخلية بين المناطق (عبر النهر) في خلال اليوم على الرغم من أن معظمها وخاصة المتجهة منها إلى الشرق وجاكار/بومثانج تغادر بين 06:30 و 07:30.	Buses depart the inter-district bus station (across the river) throughout the day, though most, especially those heading to the east and Jakar/Bumthang leave between 06:30 and 07:30.
لأن الحافلات داخل المناطق غالباً ما تكون ممتلئة، من الأفضل شراء التذاكر مسبقاً قبل بضعة أيام.	As the inter-district buses are often full, it is advisable to purchase a ticket a few days in advance.
معظم المناطق تخدمها حافلات "كوستر" يابانية صغيرة وهي مريحة وقوية.	Most districts are served by small Japanese Coaster Buses, which are comfortable and sturdy.
سيارات الأجرة المشتركة وسيلة سريعة ومريحة للتنقل إلى الأماكن المجاورة، مثل بارو (Nu 150) وبوناخا (Nu 200).	Shared taxis are a quick and comfortable means to travel to nearby places, such as Paro (Nu 150) and Punakha (Nu 200).
جسر نهر أويابوك هو جسر معلق. يمتد على نهر أويابوك لربط مدينتي أويابوك في البرازيل وسان جورج دو لويابوك في غيانا الفرنسية.	The Oyapock River Bridge is a cable-stayed bridge. It spans the Oyapock River to link the cities of Oiapoque in Brazil and Saint-Georges de l'Oyapock in French Guiana.
يبلغ ارتفاع البرجين 83 متراً، ويبلغ طولهما 378 متراً، وله مساران عرضهما 3.50 متراً.	The two towers rise to a height of 83 meters, it's 378 meters long and it has two lanes of 3.50 m wide.
المسافة الرأسية الخالية تحت الجسر ١٥ متراً. اكتمل البناء في أغسطس ٢٠١١، ولم يُفْتَحْ أمام حركة المرور حتى مارس ٢٠١٧.	The vertical clearance under the bridge is 15 meters. Construction was completed in August 2011, it didn't open to traffic until March 2017.
ومن المقرر أن يبدأ الجسر العمل بكامل طاقته في سبتمبر 2017، في نفس الوقت المتوقع عنده الانتهاء من نقاط التفتيش الجمركية البرازيلية.	The bridge is scheduled to be fully operational in September 2017, when the Brazilian customs checkpoints are expected to be finished.
كانت "الغواراني" أهم مجموعة أصلية تسكن ما يعرف الآن بباراغواي الشرقية، كان يعيش مجموعة "الغواراني" كصيادين شبه رحالة ويمارسون أيضاً زراعةَ الكفاف.	The Guaraní were the most significant indigenous group inhabiting what is now Eastern Paraguay, living as semi-nomadic hunters who also practised subsistence agriculture.
كانت منطقة تشاكو موطنًا لمجموعات أخرى من القبائل الأصلية مثل Guaycurú وPayaguá، الذين عاشوا على صيد الحيوانات، وجمع النباتات، وصيد الأسماك.	The Chaco region was home to other groups of indigenous tribes such as the Guaycurú and Payaguá, who survived by hunting, gathering and fishing.
في القرن السادس عشر، نشأت باراغواي، التي كانت تُعرف سابقًا باسم "المقاطعة العملاقة لجزر الهند" نتيجة مواجهة بين الغزاة الإسبان ومجموعات السكان الأصليين.	In the 16th century Paraguay, formerly called "The Giant Province of the Indies", was born as a result of the encounter of Spanish conquerors with the native indigenous groups.
بدأ الإسبان الحقبة الاستعماريّة التي دامت لثلاثة قرون.	The Spaniards started the colonization period which lasted for three centuries.
منذ تأسيس أسونسيون عام 1537، تمكنت باراغواي من الحفاظ على الكثير من طابعها الأصلي وهويته.	Since the foundation of Asunción in 1537, Paraguay has managed to keep a lot of its indigenous character and identity.
تشتهر الأرجنتين بوجود أحد أفضل فرق ولاعبي البولو في العالم.	Argentina is well known for having one of the best polo teams and players in the world.
تقام أكبر مسابقات العام في ديسمبر، على ملاعب بولو في لاس كانيتاس.	The largest tournament of the year takes place in December at the polo fields in Las Cañitas.
بالإضافة إلى ذلك يُمكن مشاهدة البطولات والمباريات الأصغر هنا في أوقات أخرى من السنة.	Smaller tournaments and matches can also be seen here at other times of the year.
للحصول على أخبار عن البطولات وأماكن شراء تذاكر مباريات البولو، تفقّد رابطة البولو الأرجنتينية.	For news on tournaments and where to buy tickets for polo matches, check Asociacion Argentina de Polo.
عملة فوكلاند الرسمية هي الجنيه الفوكلاندي (FKP) الذي يتم تحديد قيمته معادلة بـقيمة الجنيه البريطاني (GBP).	The official Falklands currency is the Falkland pound (FKP) whose value is set equivalent to that of one British pound (GBP).
يمكن استبدال المال في البنك الوحيد بالجزر الذي يقع في ستانلي على الجانب الأخر من متجر FIC West.	Money can be exchanged at the only bank in the islands which is located in Stanley across from the FIC West store.
يتم قبول الجنيه البريطاني بشكل عام في أي مكان في الجزر وداخل بطاقات ستانلي الائتمانية ودولار الولايات المتحدة الأمريكية في كثير من الأحيان.	British pounds will generally be accepted anywhere in the islands and within Stanley credit cards and United States dollars are also often accepted.
في الجزر النائية هناك احتمالٌ ألا يتم قبول بطاقات الائتمان، على الرغم من أنه قد يتم قبول العملة البريطانية والعملة الأمريكية؛ تحقق مسبقًا مع المالكين لمعرفة طرق الدفع المقبولة.	On the outlying islands credit cards will probably not be accepted, although British and United States currency may be taken; check with the owners in advance to determine what is an acceptable payment method.
إنه من المستحيل تقريباً صرف عملة فوكلاندس خارج الجزر، لذلك يجب صرف النقود قبل مغادرة الجزر.	It is nearly impossible to exchange Falklands currency outside of the islands, so exchange money prior to leaving the islands.
وبما أن مونتيفيديو تقع جنوب خط الاستواء، فإن فصل الصيف يكون هناك عندما يكون الشتاء في نصف الكرة الأرضية الشمالي والعكس صحيح.	Since Montevideo is south of the Equator, it is summer there when it's winter in the Northern Hemisphere and vice versa.
تقع مونتفيديو في المناطق شبه الاستوائية؛ من الشائع أن تتعدى درجات الحرارة 30 درجة مئوية في أشهر الصيف.	Montevideo is in the subtropics; in the summer months, temperatures above +30°C are common.
رُبما يكون الشتاء بارداً بشكل مخادع: نادراً ما تنخفض درجات الحرارة إلى ما دون درجة التجمد، لكن الرياح والرطوبة تجتمعان لتجعل الجو أكثر برودة مما يُشير مقياس الحرارة.	The winter can be deceptively chilly: temperatures rarely go below freezing, but the wind and humidity combine to make it feel colder than what the thermometer says.
تبقى كمية المطر ثابتة تقريباً على مدار العام، حيث لا توجد مواسم "ممطرة" وأخرى "جافة" محددة.	There are no particular "rainy" and "dry" seasons: the amount of rain stays roughly the same throughout the year.
على الرغم من أن العديد من الحيوانات في الحديقة معتادة على رؤية البشر، إلا أن الحياة البريّةَ في نهاية الأمر بريّةٌ ولا ينبغي إطعامها أو إزعاجها.	Though many of the animals in the park are used to seeing humans, the wildlife is nonetheless wild and should not be fed or disturbed.
ووفقًا لسلطات المنتزه، ابقَ بعيداً عن الدّببة والذّئاب 100 ياردة/متر على الأقلّ، وعن كلّ الحيوانات البرّيّة الأخرى 25 ياردة/مترا!	According to park authorities, stay at least 100 yards/meters away from bears and wolves and 25 yards/meters from all other wild animals!
مهما كانت سهولة الانقياد التي تبدو عليهم، فإن البيسون، الأيائل، الموظ، والدببة، وكل الحيوانات الكبيرة تقريباً قد تهاجم.	No matter how docile they may look, bison, elk, moose, bears, and nearly all large animals can attack.
يصاب عشرات الزوار كل عام بجروح لعدم بقائهم على مسافة آمنة. هذه الحيوانات كبيرة، ومتوحشة، وخطيرة للغاية ولهذا يجب عليك عدم الاقتراب منها.	Each year, dozens of visitors are injured because they didn't keep a proper distance. These animals are large, wild, and potentially dangerous, so give them their space.
إضافةً إلى ذلك، انتبه لأن الروائح جاذبة للدببة وحيوانات برية أخرى، لذا تجنّب حمل أو طهي أطعمة ذات رائحة وحافظ على نظافة المخيم.	In addition, be aware that odors attract bears and other wildlife, so avoid carrying or cooking odorous foods and keep a clean camp.
إن عاصمة ساموا هي مدينة أبيا. وتقع هذه المدينة في جزيرة أبولو ويبلغ ويبلغ عدد سكانها أقل من 40,000 نسمة بقليل.	Apia is the capital of Samoa. The town is on the island of Upolu and has a population of just under 40,000.
تأسست أبيا في خمسينيات القرن التاسع عشر وكانت العاصمة الرسمية لساموا منذ عام 1959.	Apia was founded in the 1850s and has been the official capital of Samoa since 1959.
كان المرفأ موقعاً لمواجهاتٍ بحريةٍ سيئة السمعة في عام ١٨٨٩ عندما رفضت سبع سفن من ألمانيا والولايات المتحدة وبريطانيا مغادرة الميناء.	The harbor was the site of an infamous naval standoff in 1889 when seven ships from Germany, the US, and Britain refused to leave the harbor.
لقد غرقت جميع السفن باستثناء طراد بريطاني واحد. وغرق وما يقرب من 200 شخص أمريكي وألماني.	All the ships were sunk, except for one British cruiser. Nearly 200 American and German lives were lost.
خلال الكفاح الذي نظمته حركة ماو من أجل الاستقلال، نتج عن تجمع مسالم في البلدة مقتل القائد الأعلى توبوا تماسيس ليلوفي الثالث.	During the struggle for independence organised by the Mau movement, a peaceful gathering in the town resulted in the killing of the paramount chief Tupua Tamasese Lealofi III.
نتيجة لوقوع "أوكلاند" بين مرفأين، هناك العديد من الشواطئ، يقع الأكثر شعبية في ثلاثة مناطق.	There are many beaches, due to Auckland's straddling of two harbours. The most popular ones are in three areas.
تقع شواطئ نورث شور (في منطقة نورث هاربور) على المحيط الهادئ وتمتد من لونج باي في الشمال إلى ديفونبورت في الجنوب.	North Shore beaches (in North Harbour district) are on the Pacific Ocean and stretch from Long Bay in the north to Devonport in the south.
كل الشواطئ رملية تقريباً تسمح بسباحة آمنة، ومعظمها تظلها أشجار البوتوكوا.	They are almost all sandy beaches with safe swimming, and most have shade provided by pohutukawa trees.
تقع شواطئ طرق تاماكي على مرفأ ويتيماتا، في ضواحي خليج ميشن وسانت هيليرز في وسط أوكلاند.	Tamaki Drive beaches are on the Waitemata Harbour, in the upmarket suburbs of Mission Bay and St Heliers in Central Auckland.
هذه الشواطئ العائلية مزدحمة في بعض الأحيان مع مجموعة جيدة من المتاجر التي تصطف على الشاطئ. السباحة آمنة.	These are sometimes-crowded family beaches with a good range of shops lining the shore. Swimming is safe.
تُعرف البيرة الشعبية الأساسية باسم "رقم واحد"، فهي ليست مشروبًا مركبًا، وإنما هي مشروبًا ممتعًا ومنعشًا. وتسمى البيرة المحلية الأخرى "مانتا".	The main local beer is 'Number One', it is not a complex beer, but pleasant and refreshing. The other local beer is called "Manta".
أنواع النبيذ الفرنسي متعددة، ولكن النبيذ النيوزيلندي والأسترالي قد يحظيا بانتشار أوسع.	There are many French wines to be had, but the New Zealand and Australian wines might travel better.
مياه الصنبور المحلّيّة صالحة تماماً للشرب، ولكن من السهل إيجاد زجاجات المياه، إن كنت متخوّفاً.	The local tap water is perfectly safe to drink, but bottled water is easy to find if you are fearful.
بالنسبة للأستراليين، تعد فكرة قهوة "فلات وايت" غريبة. القهوة الصغيرة السوداء هي "الإسبرسو"، والكابتشينو يكدس عليه على الأغلب القشدة (وليس الرغوة)، ويتم تقديم الشاي من دون حليب.	For Australians, the idea of 'flat white' coffee is foreign. A short black is 'espresso', cappuccino comes heaped high with cream (not froth), and tea is served without milk.
الشوكولاتة الساخنة متوافقة مع المعايير البلجيكية. عصائر الفاكهة ممتازة على الرغم من أنها باهظة الثمن.	The hot chocolate is up to Belgian standards. Fruit juices are pricey but excellent.
تُقام العديد من الرحلات إلى الشعاب المرجانية على مدار العام، ونادراً ما تحدث إصابات للشعاب المرجانية لأي من هذه الأسباب.	Many trips to the reef are made all year around, and injuries due to any of these causes on the reef are rare.
مع هذا، اطلب النصائح من السلطات، وامتثل لجميع الإشارات، وانتبه جيداً لتحذيرات السلامة.	Still, take advice from authorities, obey all signs, and pay close attention to safety warnings.
يتواجد قنديل البحر الصندوقي بالقرب من الشواطئ ومصبات الأنهار من تشرين الأول إلى نيسان شمال 1770. ويمكن العثور عليه أحياناً في غير هذه الأوقات.	Box jellyfish occur near beaches and near river estuaries from October to April north of 1770. They can occasionally be found outside these times.
أسماك القرش موجودة بالفعل، لكنها نادرًا ما تهاجم البشر. تخاف معظم أسماك القرش من البشر وتسبح بعيدًا إن رأت أحدهم.	Sharks do exist, however they rarely attack humans. Most sharks are scared of humans and would swim away.
لا تعيش تماسيح المياه المالحة عادةً في المحيط، موطنها الأساسي يقع في مصبّات الأنهار شمال روكهامبتون.	Saltwater Crocodiles do not actively live in the ocean, their primary habitat is in river estuaries north from Rockhampton.
يُطمئن الحجزُ المُسبق المسافرَ بأنّه سيكونُ لديه مكانٌ للنوم بمجرّد وصوله إلى وجهتهِ المقصودةِ.	Booking in advance gives the traveller peace of mind that they will have somewhere to sleep once they arrive at their destination.
على الرغم من أنك قد تجد أنه من الممكن حجز أشكال أخرى من الإقامة، مثل أماكن التخييم، من خلال وكيل السفر، إلا أنه غالباً ما يكون لدى وكلاء السفر صفقات مع فنادق معينة.	Travel agents often have deals with specific hotels, although you may find it possible to book other forms of accommodation, like camping grounds, through a travel agent.
جرت العادة على تقديم وكلاء السفر باقات تشمل الإفطار، وترتيبات التنقل من وإلى المطار أو حتى باقات مجمّعة تشمل الطيران والفنادق.	Travel agents usually offer packages that include breakfast, transportation arrangements to/from the airport or even combined flight and hotel packages.
كما يمكنهم الاحتفاظ بالحجز لك إذا كنت بحاجة إلى وقت للتفكير في العرض أو شراء مستندات أخرى لوجهتك (على سبيل المثال، التأشيرة).	They can also hold the reservation for you if you need time to think about the offer or procure other documents for your destination (e.g. visa).
بالرغم من ذلك، يجب توجيه أي تعديلات أو طلبات عبر وكيل السفر أولاً وليس مباشرة إلى الفندق.	Any amendments or requests though should be coursed through the travel agent first and not directly with the hotel.
بالنسبة لبعض المهرجانات، فإن الغالبية العظمى من الحاضرين في المهرجانات الموسيقية يقررون التخييم في الموقع معتبرين ذلك جزءًا مهمًا من التجربة.	For some festivals, the vast majority of the attendants to music festivals decide to camp on site, and most attendants consider it a vital part of the experience.
إذا أردت أن تقترب من الأحداث، فيجب عليك أن تدخل باكراً وذلك للحصول على موقع تخييم قريب من الموسيقى.	If you want to be close to the action you're going to have to get in early to get a camping site close to the music.
تذكر أنه على الرغم من أن الموسيقى في المنصات الرئيسية قد تكون انتهت، إلا أن هناك أقسام من المهرجان قد تستمر في تشغيل الموسيقى حتى وقت متأخر من الليل.	Remember that even though music on the main stages may have finished, there may be sections of the festival that will keep playing music until late into the night.
تضم البعض من المهرجانات مناطق تخييمٍ خاصةٍ للعائلات التي معها أولاد صغار.	Some festivals have special camping areas for families with young children.
في حال كنت تعبر منطقة بحر البلطيق الشمالية في الشتاء، فيجب أن تفحص موقع الكابينة، إذ أن المرور عبر الجليد يسبب ضوضاء صاخبة للغاية للأشخاص الأكثر تضرراً.	If crossing the Northern Baltic in winter, check the cabin location, as going through ice causes quite horrible noise for those most affected.
تشملُ رحلات سانت بطرسبرغ البحرية قضاء بعض الوقت في المدينة. يُعفى ركاب الرحلات البحرية من متطلبات الحصول على تأشيرة الدخول (راجع الشروط).	Saint Petersburg cruises include time in town. Cruise passengers are exempted from visa requirements (check the terms).
تبذل الكازينوهات عادة الكثير من الجهود لزيادة الوقت والمال الذي ينفقه الضيوف. عادة ما تكون النوافذ والساعات غائبة، وقد يكون من الصعب العثور على مخارج.	Casinos typically make many efforts to maximize time and money spent by guests. Windows and clocks are usually absent, and exits can be hard to find.
لديهم عادة وجبات خاصة، ومشروبات، وعروض ترفيهية، للحفاظ على مزاج الضيوف الجيد، وإبقائهم في المبنى.	They usually have special food, drink and entertainment offers, to keep guests in a good mood, and keep them at the premise.
تُقدِم بعض الأماكن مشروبات كحولية مجانًا، ولكن يعيق السُكْر الحُكم الصحيح على الأمور ويعلم جميع المقامرين الجيدين أهمية أن يبقى المقامر واعيًا.	Some venues offer alcoholic beverages on the house. However, drunkenness impairs judgement, and all good gamblers know the importance of staying sober.
يجب على كل من يقود سيارته على ارتفاعات عالية أو فوق الممرّات الجبليّة أن يأخذ بعين الاعتبار إمكانيّة تساقط الثّلوج أو الجليد أو درجات الحرارة تحت الصّفر.	Anyone who's going to drive at high latitudes or over mountain passes should consider the possibility of snow, ice, or freezing temperatures.
على الطرق الجليدية والثلجية، يكون الاحتكاك منخفضاً ولا تتمكّن من القيادة كما لو كنت تقود على أسفلت ناعمٍ.	On icy and snowy roadways, friction is low and you cannot drive as if you were on bare asphalt.
وأثناء العواصف الثلجية، قد تسقط كمية من الثلج تكون كافية لتوقفك لوقت قصير جداً.	During blizzards, enough snow to get you stuck can fall in very little time.
قد يتسبب تساقط الجليد أو هبوب رياح جليدية أو عملية التكثّفِ أو وجودِ الجليد على نوافذ السيارات في محدودية الرؤية.	Visibility may also be restricted by falling or blowing snow or by condensation or ice on vehicle windows.
من ناحية أخرى، تعتبر الظروف الجليدية والثلجية طبيعية في العديد من البلدان، وتستمر حركة المرور في الغالب دون انقطاع على مدار السنة.	On the other hand, icy and snowy conditions are normal in many countries, and traffic goes on mostly uninterrupted all year round.
ربما تكون رحلات السفاري هي أكبرُ عاملِ جذبٍ سياحيٍ في إفريقيا والفعالية الأهم بالنسبة لكثيرٍ من الزوار.	Safaris are perhaps the greatest tourism draw in Africa and the highlight for many visitors.
يُستخدم مصطلح رحلات السفاري عادةً للإشارة إلى السفر عبر البلاد لمشاهدة الحياة البرية المذهلة في أفريقيا، لا سيّما في السافانا.	The term safari in popular use refers to overland travel to view the stunning African wildlife, particularly on savanna.
تميل بعض الحيوانات، مثل الفيلة والزراف، إلى الاقتراب بشكل وثيق من السيارات وسوف تسمح المعدات القياسية بالمشاهدة الجيدة.	Some animals, such as elephants and giraffes, tend to approach closely to cars and standard equipment will allow good viewing.
تشعر الأسود والفهود والنمور بالخجل أحياناً ويمكنكم رؤيتهم بشكل أفضل باستعمال المنظار.	Lions, cheetahs and leopards are sometimes shy and you will see them better with binoculars.
السفاري سيراً على الأقدام (تسمى أيضاً "تنزه الأدغال" أو "التنزه سيراً على الأقدام" أو "التنزه") تتكون من المشي لمسافات طويلة، إما لبضع ساعات أو عدة أيام.	A walking safari (also called a "bush walk", "hiking safari", or going "footing") consists of hiking, either for a few hours or several days.
ستقام دورة الألعاب الأولمبية للمعاقين في الفترة من 24 أغسطس إلى 5 سبتمبر عام 2021، وستقام بعض أحداث الدورة في مواقع أخرى في أنحاء مختلفة من اليابان.	The Paralympics will take place from 24 August to 5 September 2021. Some events will be held in other locations throughout Japan.
بعد استضافة مدينة طوكيو الألعاب الأولمبية عام 1964، ستصبح المدينة الآسيوية الوحيدة التي استضافت دورة الألعاب الأولمبية الصيفية مرتين.	Tokyo will be the only Asian city to have hosted two summer Olympics, having hosted the games in 1964.
إذا حجزت رحلات الطيران والإقامة الخاصة بك لعام 2020 قبل الإعلان عن التأجيل، فربما تواجه موقفاً حرجاً.	If you booked your flights and accommodation for 2020 before the postponement was announced, you may have a tricky situation.
تتفاوت سياسات الإلغاء، ولكن اعتباراً من أواخر آذار، لم تعد معظم سياسات الإلغاء المستندة إلى فيروس كورونا حتى تموز عام 2020، عندما كان من المقرر أن يتم تنظيم الألعاب الأوليمبية.	Cancellation policies vary, but as of late March most coronavirus-based cancellation policies don't extend to July 2020, when the Olympics had been scheduled.
من المتوقع أن أغلب تذاكر الحدث ستبلغ تكلفتها بين 2,500 ين و 130,000 ين أما كلفة العادية النموذجية فستكون حوالي 7,000 ين.	It's expected that most event tickets will cost between ¥2,500 and ¥130,000, with typical tickets costing around ¥7,000.
يساعد كيّ الملابس المبلّلة على تجفيفها. توفّر العديد من الفنادق مكواة وطاولة كيّ للاستعارة، حتى إذا لم تكن موجودة بالغرفة.	Ironing damp clothes can help them dry. Many hotels have an iron and ironing board available for loan, even if one is not present in the room.
في حالة عدم تواجد أي مكواة، أو إن كنت لا تفضل ارتداء الجوارب المكوية، إذن تستطيع أن تجرب استخدام مجفف الهواء، إذا كان متاحاً.	If an iron isn't available, or if you don't fancy wearing ironed socks, then you can try using a hairdryer, if available.
لا تجعل القماش يصبح ساخنًا أكثر من اللازم (مما قد يؤدي إلى انكماشه أو احتراقه في أسوأ الحالات).	Be careful not to allow fabric to become too hot (which can cause shrinkage, or in extreme cases, scorch).
هناك طرق مختلفة لتنقية المياه، بعضها مجدية أكثر ضد تهديدات معينة.	There are different ways of purifying water, some more effective against specific threats.
في بعض المناطق يكفي غليان الماء لمدة دقيقة، وفي مناطق أخرى تحتاج إلى غليها لعدة دقائق.	In some areas boiling water for a minute is enough, in others several minutes are needed.
تختلف المرشحات من حيث الفاعلية، إذا كان لديك أي مخاوف، فعليك التفكير في شراء مياهك في زجاجات محكمة الغلق من شركة حسنة السمعة.	Filters vary in effectiveness, and should you have a concern, then you should consider buying your water in a sealed bottle from a reputable company.
من المحتمل أن يواجه المسافرون آفات حيوانية ليسوا على دراية بها في مناطقهم الأصلية.	Travellers may encounter animal pests that they are not familiar with in their home regions.
قد تُفسد الآفات الطعام، وتسبب الإزعاج، أو تسبب ردود فعل تحسسية في الحالات الأسوأ، وتنشر السم، أو تنقل العدوى.	Pests can spoil food, cause irritation, or in a worse case cause allergic reactions, spread venom, or transmit infections.
فالأمراض المعدية ذاتها، أو الحيوانات الخطرة التي يمكن أن تصيب أو تقتل الناس بالقوة، لا توصف عادة بأنها آفات.	Infectious diseases themselves, or dangerous animals that can injure or kill people by force, do not usually qualify as pests.
يحتوي الامتداد بين بوينت ماريون و فيرمونت على أصعب ظروف القيادة على طريق بافلو-بيتسبرغ السريع، حيث يمر بشكل منتظم عبر تضاريس غابات معزولة.	The stretch between Point Marion and Fairmont presents the most challenging driving conditions on the Buffalo-Pittsburgh Highway, passing frequently through isolated backwoods terrain.
إذا لم تكن معتاداً على القيادة على الطرق الريفية، فكن حذراً: يوجد دائماً منحدرات حادة وممرات ضيقة ومنحنيات حادة.	If you're not used to driving on country roads, keep your wits about you: steep grades, narrow lanes, and sharp curves predominate.
حدود السرعة المعلنة أقل بشكل ملحوظ مما كانت عليه في الأقسام السابقة واللاحقة — عادة 35-40 ميل في الساعة (56-64 كم / ساعة) — والطاعة الصارمة لهم أكثر أهمية من غير ذلك.	Posted speed limits are noticeably lower than in previous and subsequent sections — commonly 35-40 mph (56-64 km/h) — and strict obedience to them is even more important than otherwise.
غريب، بالرغم من أن خدمة الهواتف النقالة أقوى هنا من الكثير من المناطق الأخرى بالطريق. على سبيل المثال غابات بنسلفانيا.	Curiously, though, mobile phone service is much stronger here than along many other stretches of the route, e.g. the Pennsylvania Wilds.
أوروبا قارة صغيرة نسبياً ولكن فيها العديد من الدول المستقلة. وفي ظل الظروف العادية، فإن السفر عبر عدة بلدان يعني اضطرارك إلى المرور عبر طلبات الحصول على التأشيرة ومراقبة جوازات السفر عدة مرات.	Europe is a continent that is relatively small but with many independent countries. Under normal circumstances, travelling through multiple countries would mean having to go through visa applications and passport control multiple times.
وبالرغم من ذلك، فإن منطقة شنغن تعمل إلى حد ما كدولة واحدة في هذا الشأن.	The Schengen zone, however, works somewhat like one country in this respect.
طالما أنكم باقون في هذه المنطقة، يمكنكم عبور الحدود بشكل عام من دون الحاجة للمرور بنقاط تفتيش جوزات السفر مرة أخرى.	As long as you stay in this zone, you can generally cross borders without going through passport control checkpoints again.
وعلى نحو مماثل، فمن خلال الحصول على تأشيرة شنغن، لن تكون في احتياج إلى التقدم بطلب للحصول على تأشيرات الدخول لكل دولة من البلدان الأعضاء في شنغن على حدة، وبالتالي توفير الوقت والمال والأعمال الورقية.	Similarly, by having a Schengen visa, you do not need to apply for visas to each of the Schengen member countries separately, hence saving time, money and paperwork.
تضع بعض وكالات الضرائب تعريفاً للتحف بأنها بضائع زاد عمرها عن مائة عام، ولكن ليس هناك تعريف جامع لما نعتبره تحفاً من العناصر المصنّعة.	There is no universal definition for which manufactured items are antiques. Some tax agencies define goods older than 100 years as antiques.
للتعريف اختلافات جغرافية، حيث قد يكون الحد العمري أقصر في أماكن مثل أمريكا الشمالية منه في أوروبا.	The definition has geographic variations, where the age limit might be shorter in places such as North America than in Europe.
قد تعرف منتجات الحرف اليدوية على أنها تحف رغم أنها أحدث من السلع المماثلة التي أنتجت جماعيًا في الماضي البعيد.	Handicraft products might be defined as antiques, though they are younger than similar mass-produced goods.
تُعد تربية الرنة مصدر رزق مهم بالنسبة للصاميين، كما أن الثقافة المحيطة بالتجارة مهمة أيضاً للعديد من أصحاب المهن الأخرى.	Reindeer husbandry is an important livelihood among the Sámi and the culture surrounding the trade is important also for many with other professions.
وحتى تقليدياً، وعلى الرغم من ذلك، لم يشترك جميع قومية سامي في تربية الرنة على نطاق واسع، لكنهم كانوا يعيشون من صيد الأسماك والصيد وما شابه ذلك، واستخدموا الرنة في الغالب كحيوانات للجر.	Even traditionally, though, not all Sámi have been involved in big scale reindeer husbandry, but lived from fishing, hunting and similar, having reindeer mostly as draft animals.
يعمل العديد من الساميين اليوم في الحرف الحديثة. وتُعد السياحة دخلًا مهماً في سابمي، منطقة الساميين.	Today many Sámi work in modern trades. Tourism is an important income in Sápmi, the Sámi area.
بالرغم من انتشار استخدام كلمة "غجر" وخاصةً في أوساط غير الرومن، إلا أنها تعتبر كلمة مسيئة لارتباطها بصور نمطية سلبية وتصورات غير دقيقة عن الرومن.	Though it is widely used, especially among non-Romani, the word "Gypsy" is often considered offensive because of its associations with negative stereotypes and inaccurate perceptions of Romani people.
إذا أصبحت الدولة التي ستزورها خاضعة لمشورة تتعلق بالسفر، فقد يتأثر التأمين الصحي للسفر أو تأمين إلغاء الرحلة.	If the country you will be visiting becomes subject to a travel advisory, your travel health insurance or your trip cancellation insurance may be affected.
ربما ترغب أيضاً في طلب المشورة من حكومات غير حكومتك، ولكن نصيحة تلك الحكومات صادرة خصيصاً لمواطنيها.	You may also wish to consult the advice of governments other than your own, but their advice is designed for their citizens.
على ذكر مثال واحد، قد يواجه المواطنون الأمريكيون في الشرق الأوسط مواقف تختلف عما يواجهه الأوروبيون أو العرب.	As one example, American citizens in the Middle East might face different situations from Europeans or Arabs.
تحذيرات السفر هي مجرد ملخصٍ للوضعِ السياسيِّ في بلد ما.	Advisories are merely a brief summary of the political situation in one country.
غالباً ما تكون الآراء المقدّمة سريعةً وعامةً ومبسطةً مقارنةً بالمعلومات الأكثر تفصيلاً المتوفرة في أماكن أخرى.	The views presented are often cursory, general and oversimplified compared to the more detailed information available elsewhere.
الطقس القاسي هو المصطلح العام لأي ظاهرة مناخية خطيرة قد تسبب ضررًا أو اضطرابًا اجتماعيًا خطيرًا، أو خسارة في الأرواح.	Severe weather is the generic term for any dangerous weather phenomenon with the potential to cause damage, serious social disruption, or loss of human life.
قد يحدث الطقس القاسي في أي مكان في العالم، وتوجد أنواع مختلفة منه اعتمادًا على الجغرافيا، والطبوغرافيا، والظروف الجوية.	Severe weather can occur anywhere in the world, and there are different types of it, which can depend on geography, topography, and atmospheric conditions.
إن الرياح الشديدة والبَرَد والتهطال المفرط والحرائق البرية هي أشكال وآثار الطقس الشديد، وكذلك العواصف الرعدية والأعاصير والفيضانات والأعاصير الحلزونية.	High winds, hail, excessive precipitation, and wildfires are forms and effects of severe weather, as are thunderstorms, tornadoes, waterspouts, and cyclones.
تشمل الظواهر المناخية الإقليمية والموسمية الشديدة: العواصف الثلجية والجليدية والترابية.	Regional and seasonal severe weather phenomena include blizzards, snowstorms, ice storms, and dust storms.
يُنصح المسافرون بشدة أن يلّموا بأي مخاطر لوقوع أحداث طقس قاسية في الأماكن التي يزورونها لما لذلك من تأثير على خطط سفرهم.	Travellers are strongly advised to be aware of any risk of severe weather affecting their area as they may affect any travel plans.
وكل من يخطط لزيارة دولة قد تعتبر منطقة حرب فلابد وأن يحصل على تدريب مهني.	Anyone planning a visit to a country that could be considered a war zone should get professional training.
قد يُفضي البحث على الإنترنت عن "دورة البيئة العدائية" إلى عنوان شركة محلية.	A search of the Internet for 'Hostile environment course' will probably provide the address of a local company.
عادةً ما تشمل الدورة جميع المشاكل التي تتم مناقشتها هنا بتفصيلٍ أكبر بكثيرٍ وعادةً ما يكون من خلال التجربة العملية.	A course will normally cover all the issues discussed here in far greater detail, usually with practical experience.
تستمر الدورة عادةً من 2 إلى 5 أيام وتتضمن لعب الأدوار والكثير من الإسعافات الأولية وفي بعض الأحيان التدرب على الأسلحة.	A course will normally be from 2-5 days and will involve role play, a lot of first aid and sometimes weapons training.
يوجد العديد من الكتب والمجلات التي تتناول البقاء على قيد الحياة في البرية بينما المطبوعات التي تتناول مناطق الحرب قليلة.	Books and magazines dealing with wilderness survival are common, but publications dealing with war zones are few.
يجب على المسافرين الذين يخططون لإجراء جراحة إعادة تحديد الجنس في الخارج التأكّد من أنهم يحملون وثائق صالحة لرحلة العودة.	Voyagers planning sex reassignment surgery abroad must ensure they're carrying valid documents for the return trip.
يتفاوت استعداد الحكومات لإصدار جوازات سفر بلا ذكر لنوع الجنس (X) أو إصدار مستندات محدثة لتناسب اسم أو نوع جنس مرغوب فيهما.	The willingness of governments to issue passports with gender not stated (X) or documents updated to match a desired name and gender varies.
يختلف استعداد الحكومات الأجنبية في احترامها لهذه الوثائق إلى حدٍ بعيد.	Willingness of foreign governments to honour these documents is just as widely variable.
وأصبحت عمليات التفتيش في نقاط التفتيش الأمنية أكثر تعدياً على الخصوصيات بكثير في حقبة ما بعد 11 سبتمبر عام 2001.	Searches at security checkpoints have also become far more intrusive in the post-September 11, 2001 era.
يجب ألا يتوقع المتحولين جنسياً قبل الجراحة المرور عبر الماسحات مع الحفاظ على خصوصيتهم و كرامتهم.	Pre-operative transgender people should not expect to pass through the scanners with their privacy and dignity intact.
تيارات السحب هي التدفق العائد من الأمواج التي تقطع الشاطئ، غالباً عند الشعاب المرجانية أو شيءٍ من ذلك القبيل.	Rip currents are the returning flow from waves breaking off the beach, often at a reef or similar.
نظراً للتّضاريس تحت المياه، يتركّز التّدفق العائد في بضعة أقسام عميقةٍ، وقد يتشكّل تيارٌ سريعٌ إلى المياه العميقة هناك.	Due to the underwater topology the return flow is concentrated at a few deeper sections, and a fast current to deep water may form there.
تنتجُ معظمُ الوفيّاتِ عن الإرهاقِ في محاولةِ السّباحة عكس التيّار، وهو ما قد يكونُ مستحيلاً.	Most deaths happen as result of fatigue trying to swim back against the current, which may be impossible.
حالما تسبح خارج التيار ستكون السباحة في العودة لا تقل سهولة عن المعتاد.	As soon as you get out of the current, swimming back is no more difficult than normally.
حاول استهداف مكان لا يسيطر عليك التيار فيه مرة أخرى أو، على حسب مهاراتك وما إذا لاحظ وجودك أحدهم، قد يكون انتظار الإنقاذ اختيار آخر.	Try aiming somewhere where you are not caught again or, depending on your skills and on whether you have been noticed, you might want to wait for rescue.
تحدث صدمة العودة إلى الوطن الأم أسرع من الصدمة الثقافية (تقصر مرحلة شهر العسل)، وتستمر لفترة أطول، ويمكن أن تكون أكثر حدة.	Re-entry shock comes on sooner than culture shock (there's less of a honeymoon phase), lasts longer, and can be more severe.
في بعض الأحيان، يواجه المسافرون الذين يجدون سهولة في التكيف مع الثقافة الجديدة صعوبة خاصة في إعادة التكيف مع ثقافتهم الأصلية.	Travellers who had an easy time adjusting to the new culture sometimes have a particularly hard time readjusting to their native culture.
عند العودة إلى الوطن بعد العيش في الخارج، تكون قد تكيفت مع الثقافة الجديدة وفقدت بعضاً من عاداتك من ثقافة وطنك.	When returning home after living abroad, you've adapted to the new culture and lost some of your habits from your home culture.
عندما سافرت إلى الخارج في البداية، ربما كان الناس صبورين ومتفهمين، مع العلم أن المسافرين في بلد جديد بحاجة إلى التكيف.	When you went abroad at first, people were probably patient and understanding, knowing that travellers in a new country need to adapt.
قد لا يتوقع الناس أن الصبر والتفاهم ضروريان أيضاً للمسافرين العائدين إلى ديارهم.	People may not anticipate that patience and understanding are also necessary for travellers returning home.
إن عرض الصوت والضوء الهرمي واحد من أمتع الأشياء الموجودة بالمنطقة للأطفال.	The pyramid sound and light show is one of the most interesting things in the area for kids.
بإمكانك أن ترى الأهرام في الظلام وفي صمت قبل أن يبدأ العرض.	You can see the pyramids in the dark and you can see them in silence before the show begins.
يمكنك أن تسمع صوت السيّاح والبائعين هنا دائماً عادةً. فقصة الصوت والضوء تشبه قصة كتابٍ.	Usually you always here the sound of tourists and vendors. The story of the sound and light is just like a story book.
وُضع أبو الهول كخلفيّة وراوٍ لقصّة طويلة.	The Sphinx is set as the backdrop and the narrator of a long story.
يتم عرض المشاهد على الأهرامات و تضاء الأهرامات المختلفة.	The scenes are displayed on the pyramids and the different pyramids are lit up.
يمكن أن يكون السفر بالطائرة تجربة مرعبة للأشخاص من جميع الأعمار والخلفيات، خاصةً إذا لم يسافروا من قبل أو تعرضوا لحادثٍ مؤلمٍ.	Travelling by plane can be a scary experience for people of all ages and backgrounds, particularly if they've not flown before or have experienced a traumatic event.
إنه ليس أمراً يُخجل منه: فهو لا يختلف كثيراُ عن المخاوف الشخصية و الأشياء الأخرى المكروهة و التي يمتلكها الكثير من الناس.	It is not something to be ashamed of: it is no different from the personal fears and dislikes of other things that very many people have.
قد يساعد فهم شيء ما حول كيفية عمل الطائرات وما يحدث أثناء الرحلة البعض في التغلب على الخوف الذي ينبع من المجهول أو من عدم السيطرة.	For some, understanding something about how aircraft work and what happens during a flight may help to overcome a fear which is based on the unknown or on not being in control.
يتم دفع مبالغ جيدة لشركات الشحن لإيصال الأشياء بسرعة. عادة ما يكون الوقت مهماً للغاية فيما يتعلق بمستندات العمل، البضائع وقطع الغيار للإصلاحات العاجلة.	Courier companies are well paid for delivering things quickly. Frequently, time is very important with business documents, merchandise or spare parts for an urgent repair.
تمتلك الشركات الأكبر طائراتها الخاصة، في بعض الخطوط، ولكن كانت هناك مشكلة للخطوط الأخرى والشركات الأصغر.	On some routes, the larger companies have their own planes, but for other routes and smaller firms there was a problem.
في حالة إرسالهم الأشياء عن طريق الشحن الجوي، فربما يستغرق الأمر عدة أيام في بعض الطرق للتفريغ والجمارك.	If they sent things by air freight, on some routes it may have taken days to get through unloading and customs.
إرسال الطرود كأمتعة يتم فحصها كان الطريق الأوحد لتستلمها سريعاً، ولكن لا تسمح القوانين الداخلية لشركات الطيران بإرسال أمتعة بلا راكب، لذا يأتي دورك في هذه المرحلة.	The only way to get it through faster was to send it as checked luggage. Airline regulations will not allow them to send luggage without a passenger, which is where you come in.
الطريق البديهي لتتمكن من السفر على الدرجة الأولى أو درجة رجال الأعمال هي تخصيص مبلغ مالي كبير لتحصل على هذا الامتياز (أو أفضل لك أن تنيب شركتك في القيام بذلك).	The obvious way of flying in first or business class is to fork out a thick wad of money for the privilege (or, better yet, get your company to do it for you).
مع ذلك، فإن هذا لا يأتي بثمن بخس: كقواعد الإبهام الصارمة، يمكنك أن تتوقع أن تدفع ما يصل إلى أربعة أضعاف الأجرة الاقتصادية العادية للأعمال التجارية، وأحد عشر ضعفاً للدرجة الأولى!	However, this does not come cheap: as rough rules of thumb, you can expect to pay up to four times the normal economy fare for business, and eleven times for first class!
بصفة عامة، لا جدوى من البحث عن خصومات لمقاعد فئة رجال الأعمال أو الدرجة الأولى على الرحلات المباشرة من A إلى B.	Generally speaking, there is no point in even looking for discounts for business or first-class seats on direct flights from A to B.
تعلم الخطوط الجوية جيداً أن هناك مجموعة رئيسية محددة من المسافرين مستعدون لدفع الكثير من المال مقابل أفضلية الوصول إلى مكان ما بسرعة وفي راحة، وتتم محاسبتهم وفقاً لذلك.	Airlines know well that there is a certain core group of flyers who are willing to pay top dollar for the privilege of getting somewhere fast and in comfort, and charge accordingly.
عاصمة مولدوفا كيشيناو. اللغة المحلية هي الرومانية لكن الروسية مستخدمة على نطاق واسع.	The capital of Moldova is Chişinău. The local language is Romanian, but Russian is widely used.
مولدوفا جمهورية متعددة الأعراق عانت من صراع عرقي.	Moldova is a multi-ethnic republic that has suffered from ethnic conflict.
في سنة 1994 أدى هذا النزاع إلى إنشاء جمهورية ترانسنيستريا التي نصبت نفسها بنفسها في شرق مولدوفا، والتي لها حكومتها و عملتها الخاصة غير أنه غير معترف بها من قبل أي دولة عضو في الأمم المتحدة.	In 1994, this conflict led to the creation of the self-proclaimed Transnistria Republic in eastern Moldova, which has its own government and currency but is not recognised by any UN member country.
ولقد أعيد تأسيس الروابط الاقتصاديّة بين هذين الجزأين من مولدوفا على الرّغم من الفشل في المفاوضات السياسيّة.	Economic links have been re-established between these two parts of Moldova despite the failure in political negotiations.
الديانة الرئيسية في "مولدوفا" هي المسيحية الأرثوذكسية.	The major religion in Moldova is Orthodox Christian.
تعد مدينة إزمير ثالث أكبر مدينة في تركيا ويبلغ عدد سكانها حوالي 3.7 مليون نسمة، وبها ثاني أكبر ميناء بعد اسطنبول، كما تعد مركزاً متميزاً للنقل.	İzmir is the third largest city in Turkey with a population of around 3.7 million, the second biggest port after Istanbul, and a very good transport hub.
كانت مدينة سميرنا القديمة ذات يوم، وهي الآن مركز تجاري حديث ومتطور ومزدحم، يقع حول خليج ضخم محاط بالجبال.	Once the ancient city of Smyrna, it is now a modern, developed, and busy commercial center, set around a huge bay and surrounded by mountains.
تتميز الشوارع الواسعة والمباني ذات الواجهة الزجاجية ومراكز التسوق الحديثة بأسقف تقليدية من القرميد الأحمر وسوق القرن الثامن عشر والمساجد والكنائس القديمة، على الرغم من أن المدينة تتمتع بجو أكثر من أوروبا المتوسطية مقارنة بتركيا التقليدية.	The broad boulevards, glass-fronted buildings and modern shopping centers are dotted with traditional red-tiled roofs, the 18th century market, and old mosques and churches, although the city has an atmosphere more of Mediterranean Europe than traditional Turkey.
توفر قرية هالدارسفيك إطلالات على جزيرة إيستروي القريبة وتحتوي على كنيسة فريدة بتصميم ثماني.	The village of Haldarsvík offer views of the nearby island Eysturoy and has an unusual octagonal church.
في باحة الكنيسة، توجد تماثيل رخامية بديعة للحمام فوق بعض المقابر.	In the churchyard, there are interesting marble sculptures of doves over some tombs.
يستحق الأمر نصف ساعة من التجوّل في القرية المثيرة للاهتمام.	It's worth half an hour to stroll about the intriguing village.
تقع مدينة سنترا الرومانتيكية ذات الجمال الخلاب ناحية الشمال في مكان يسهل الوصول إليه، وهي المدينة التي ذاع صيتها وسط الأجانب بعد سرد اللورد بايرن المبهر لروائعها.	To the north and within easy reach is the romantic and fascinating town of Sintra and which was made famous to foreigners after a glowing account of its splendours recorded by Lord Byron.
تسافر حافلة "سكوترب 403" بانتظام إلى "سينترا"، وتتوقف في "كابو دا روكا".	Scotturb Bus 403 travels regularly to Sintra, stopping at Cabo da Roca.
إضافة إلى ذلك من ناحية الشمال يمكنك زيارة حرم السيدة فاطمة العظيم (ضريح مقدس)، وهو مكان الظهورات المريمية الشهيرة على مستوى العالم.	Also to the north visit the great Sanctuary of Our Lady of Fatima (Shrine), a place of worldwide famous Marian apparitions.
من فضلك تذكر أنك في الأساس في موقع مقبرة جماعية، بالإضافة إلى أنه موقع له معنى يكاد يكون غير متناهي بالنسبة لجزء هائل من سكان العالم.	Please remember that you are essentially visiting a mass grave site, as well as a site that has an almost incalculable meaning to a significant portion of the world's population.
لا يزال هناك العديد من الرجال والنساء على قيد الحياة من ممن نجوا من وقتهم هنا، والعديد من الأشخاص الآخرين الذين كان عندهم أحباء قُتلوا أو عملوا حتى الموت هناك، من اليهود وغير اليهود على حد سواء.	There are still many men and women alive who survived their time here, and many more who had loved ones who were murdered or worked to death there, Jews and non-Jews alike.
يرجى التّعامل مع الموقع بكل ما يستحقه من كرامة ووقار واحترام. لا تطلقوا النكات عن الهولوكوست أو النازيين.	Please treat the site with all of the dignity, solemnity and respect it deserves. Do not make jokes about the Holocaust or Nazis.
لا تشوه الموقع بوضع علامات أو الكتابات الخادشة على الجدران في المباني.	Do not deface the site by marking or scratching graffiti into structures.
لمدينة برشلونة لغتين رسميتين هما الكتالونية والإسبانية. يُفضل حوالي نصف السكان التحدث بالكتالونية، ويفهمها الغالبية العظمى، ويعرف الجميع تقريبًا الإسبانية.	Barcelona's official languages are Catalan and Spanish. About a half prefer to speak Catalan, a vast majority understands it, and virtually everyone knows Spanish.
ومع هذا فمعظم الإشارات يتم التعبير عنها باللغة الكاتالونية لأنها وبموجب القانون تعتبر اللغة الرسمية الأولى.	However, most signs are indicated only in Catalan because it is established by law as the first official language.
وبالرغم من ذلك، يشيع استخدام اللغة الإسبانية في المواصلات العامة ومرافق أخرى.	Yet, Spanish is also widely used in public transport and other facilities.
يتم إذاعة الإعلانات المنتظمة في المترو باللغة الكاتالونية فقط، بينما يتم إذاعة الاضطرابات غير المتوقعة بواسطة نظام آلي في مجموعة متنوعة من اللغات تشمل الإسبانية والإنجليزية والفرنسية والعربية واليابانية.	Regular announcements in the Metro are made only in Catalan, but unplanned disruptions are announced by an automated system in a wide variety of languages including Spanish, English, French, Arabic and Japanese.
يشتهر أهل باريس بالأنانية والوقاحة والغطرسة.	Parisians have a reputation for being egocentric, rude and arrogant.
الطريقة المثلى للتعايش في مدينة باريس التصرف بدماثة خلق كشخص"bien élevé" أي حسن التربية، رغم أن الأمر لا يخرج عادةً عن كونه صورة نمطية خاطئة.	While this is often only an inaccurate stereotype, the best way to get along in Paris still is to be on your best behavior, acting like someone who is "bien élevé" (well brought up). It will make getting about considerably easier.
ستتبخر الأجزاء الخارجية الباريسية الفظة بسرعة إذا ما قمت بعرض بعض المجاملات الأساسية.	Parisians' abrupt exteriors will rapidly evaporate if you display some basic courtesies.
تملأ الغابات الكثيفة منتزه بحيرات بليفيتش الوطني وتشكلها بالأساس أشجار الزان والتنوب والشوح، ويميزه مزيج من نباتات الألب والبحر الأبيض المتوسط.	The Plitvice Lakes national park is heavily forested, mainly with beech, spruce, and fir trees, and features a mixture of Alpine and Mediterranean vegetation.
تمتلك مجموعة كبيرة ومتنوعة من المجتمعات النباتية، بسبب نطاق المناخات المحلية، وأنواع التربة المختلفة، ومستويات الارتفاع المتفاوتة.	It has a notably wide variety of plant communities, due to its range of microclimates, differing soils and varying levels of altitude.
تأوي المنطقة أيضاً تشكيلة متنوعة للغاية من انواع سلالات الحيوانات والطيور.	The area is also home to an extremely wide variety of animal and bird species.
يمكن العثور هناك على حيوانات ذات فصائل نادرة مثل الدب البني الأوروبي والذئب والنسر والبومة والوشق والقط البري وديك الخلنج، بجانب العديد من الأنواع الأخرى الأكثر شيوعاً.	Rare fauna such as the European brown bear, wolf, eagle, owl, lynx, wild cat and capercaillie can be found there, along with many more common species
أثناء زيارة الأديرة، يُطلب من النساء ارتداء التنانير التي تغطي الركبتين وتغطية أكتافهن، أيضاً.	While visiting the monasteries, women are required to wear skirts covering the knees and have their shoulders covered, too.
توفر معظم الأديرة مَلاحِف للنساء اللائي يأتين غير مستعدات، ولكن إذا أحضرتِ الملحفة الخاصة بك، وخاصةً ذات الألوان الزاهية، فسوف تحظين بابتسامة من الراهب أو الراهبة عند المدخل.	Most of the monasteries do provide wraps for women who come unprepared, but if you bring your own, especially one with bright colors, you'll get a smile from the monk or nun at the entrance.
وعلى غرار ذلك، يُطلب من الرجال ارتداء سراويل تغطي الركبتين	Along the same line, men are required to wear trousers covering the knees.
يُمكن استعارة هذا أيضاً من المخزن عند المدخل، ولكن لا يتم غسل هذه الملابس بعد كل مستخدم، لذلك قد لا تشعر بالراحة عند ارتداء هذه التنورات. مقاسٌ واحدٌ يناسبُ جميعَ الرِّجَالِ!	This too can be borrowed from the stock at the entrance but that clothing isn't washed after every user so you may not feel comfortable wearing these skirts. One size fits all for men!
يعتمد مطبخ مايوركا، مثل بقية المناطق المماثلة في البحر الأبيض المتوسط، على الخبز والخضروات واللحوم (خاصة لحم الخنزير)، ويُستخدم زيت الزيتون في جميع الأشياء.	Majorcan cuisine, like that of similar zones in the Mediterranean, is based on bread, vegetables and meat (specially pork), and uses olive oil throughout.
يُعد "الخبز بزيت الزيتون" من أمثلة العشاء الشعبي البسيط، خاصة أثناء فصل الصيف: خبز بزيت الزيتون والطماطم وأي توابل متوفرة مثل: الجبن، وسمك التونة، وما إلى ذلك.	A simple popular dinner, especially during the summer, is the Pa amb Oli: Bread with olive oil, tomato, and any available condiments such as cheese, tunafish, etc.
