המטוס מדגם The JAS 39C Gripen התרסק על המסלול בסביבות השעה 9:30 בבוקר בזמן המקומי (0230 UTC) והתפוצץ, מה שגרם לסגירת שדה התעופה לטיסות מסחריות.	The JAS 39C Gripen crashed onto a runway at around 9:30 am local time (0230 UTC) and exploded, closing the airport to commercial flights.
הטייס זוהה כמפקד הטייסת דילוקריט פאטאבי.	The pilot was identified as Squadron Leader Dilokrit Pattavee.
כלי תקשורת מקומיים מדווחים שרכב כיבוי של נמל התעופה התהפך בדרכו לזירה.	Local media reports an airport fire vehicle rolled over while responding.
ב-08:46 בדיוק נפלה דממה ברחבי העיר, לציון הרגע המדויק שבו תקף המטוס הראשון את מטרתו.	At exactly 8:46 a.m. a hush fell across the city, marking the exact moment the first jet struck its target.
שתי אלומות אור הורכבו כך שיצביעו לשמיים כל הלילה.	Two beams of light have been rigged up to point skywards overnight.
כעת נבנים באתר חמישה גורדי שחקים חדשים, שביניהם יהיו מרכז תעבורה ופארק זיכרון.	Construction is ongoing for five new skyscrapers at the site, with a transportation center and memorial park in the middle.
גם הצי האמריקני אמר כי הם חוקרים את האירוע.	The US Navy also said they were investigating the incident.
"עוד אמרו בהצהרה, הצוות עובד כרגע כדי לקבוע מה השיטה הטובה ביותר לחילוץ הספינה בבטחה."	They also said in a statement, "The crew is currently working to determine the best method of safely extracting the ship".
הספינה, שהיא ספינת פינוי מוקשים מסוג אוונג'ר, הייתה בדרכה לפוארטו פרינססה באי פאלאוואן.	An Avenger class mine countermeasures ship, the ship was on its way to Puerto Princesa in Palawan.
היא משויכת  לצי השביעי של חיל הים האמריקאי ובסיסה בסאסבו, נגאסאקי ביפן.	It is assigned to the U.S. Navy’s Seventh Fleet and based in Sasebo, Nagasaki in Japan.
"למזלי שום דבר לא קרה לי, אבל ראיתי סצנה מקברית, כשאנשים ניסו לשבור חלונות כדי לצאת."	"Luckily nothing happened to me, but I saw a macabre scene, as people tried to break windows in order to get out.
אנשים הכו את החלונות בכיסאות, אך השמשות לא נשברו.	People were hitting the panes with chairs, but the windows were unbreakable.
"אחת השמשות נשברה בסוף והם התחילו לצאת החוצה דרך החלון, אמר הניצול פרנצ'ישק קובאל."	One of the panes finally broke, and they started to get out by the window," said survivor Franciszek Kowal.
לאחר התאונה, גיבסון הובהל לבית חולים אבל מת זמן קצר לאחר מכן.	After the accident occurred, Gibson was transported to a hospital but died shortly afterwards.
נהג המשאית, בן 64, לא נפגע בתאונה.	The truck driver, who is aged 64, was not injured in the crash.
הרכב עצמו נלקח מזירת התאונה באותו יום בסביבות 12:00 שעון גריניץ'.	The vehicle itself was taken away from the scene of the accident at approximately 1200 GMT on the same day.
"אדם שעובד במוסך סמוך למקום בו אירעה התאונה אמר: היו ילדים שחיכו לחצות את הכביש וכולם צרחו ובכו."	A person working in a garage near where the accident occurred said: "There were children waiting to cross the road and they were all screaming and crying."
כולם רצו הרחק ממקום התרחשות התאונה.	They all ran back from where the accident had happened.
למרות ששלושה אנשים היו בתוך הבית כשהמכונית פגעה בו, אף אחד מהם לא נפגע.	Although three people were inside the house when the car impacted it, none of them were hurt.
עם זאת, הנהג סבל מפציעות חמורות בראשו.	However, the driver sustained serious injuries to the head.
הכביש בו אירעה ההתנגשות נסגר באופן זמני בזמן ששירותי החירום חילצו את הנהג מהאאודי TT האדומה.	The road where the crash happened was temporarily closed while emergency services freed the driver from the red Audi TT.
הוא אושפז תחילה בבית החולים ג'יימס פייג'ט בגרייט יארמות'.	He was initially hospitalised in the James Paget Hospital in Great Yarmouth.
לאחר מכן, הוא הועבר לבית החולים אדנברוק בקיימברידג'.	He was subsequently relocated to Addenbrooke's Hospital in Cambridge.
