דפוסי מחשבה מתכנסים הם טכניקות לפתרון בעיות שמשלבות רעיונות או תחומים שונים כדי למצוא פתרון.	Convergent thinking patterns are problem solving techniques that unite different ideas or fields to find a solution.
הדגש של דפוס חשיבה זה הוא מהירות, לוגיקה ודיוק, וכן זיהוי עובדות, יישום מחדש של טכניקות קיימות, איסוף מידע.	The focus of this mindset is speed, logic and accuracy, also identification of facts, reapplying existing techniques, gathering information.
הגורם החשוב ביותר של דפוס חשיבה זה הוא: יש רק תשובה אחת נכונה. חושבים על שתי תשובות בלבד, והן נכון או לא נכון.	The most important factor of this mindset is: there is only one correct answer. You only think of two answers, namely right or wrong.
סוג כזה של חשיבה קשור למדעים מסוימים או לנהלים סטנדרטיים.	This type of thinking is associated with certain science or standard procedures.
לאנשים עם סוג כזה של חשיבה יש חשיבה לוגית, והם יכולים לשנן תבניות, לפתור בעיות ולעבוד על מבחנים מדעיים.	People with this type of thinking have logical thinking, are able to memorize patterns, solve problems and work on scientific tests.
בני אדם הם המין המוכשר ביותר בפער גדול בקריאת מחשבותיהם של אחרים.	Humans are by far the most talented species in reading the minds of others.
כלומר, אנו מסוגלים לחזות בהצלחה את מה שבני אדם אחרים קולטים, מתכוונים, מאמינים, יודעים או רוצים.	That means we are able to successfully predict what other humans perceive, intend, believe, know or desire.
בקרב היכולות האלו, הבנת כוונתם של אחרים היא בעלת חשיבות מכרעת. היא מאפשרת לנו לפתור עמימות אפשרית של פעולות פיזיות.	Among these abilities, understanding the intention of others is crucial. It allows us to resolve possible ambiguities of physical actions.
לדוגמה, אם הייתם רואים מישהו שובר חלון של מכוניות, כנראה הייתם מניחים שהוא מנסה לגנוב מכונית של אדם זר.	For example, if you were to see someone breaking a car window, you would probably assume he was trying to steal a stranger’s car.
יהיה צורך לשפוט אותו בצורה אחרת אם הוא איבד את מפתחות רכבו וזו המכונית שלו שאליה הוא מנסה לפרוץ.	He would need to be judged differently if he had lost his car keys and it was his own car that he was trying to break into.
"סריקת MRI מתבססת על תופעה בפיזיקה בשם תהודה מגנטית גרעינית (NMR), שהתגלתה בשנות ה-30 עי פליקס בלוך (כשעבד באוניברסיטת סטנפורד) ואדוארד פרסל (מאוניברסיטת הרווארד)"	MRI is based on a physics phenomenon called nuclear magnetic resonance (NMR), which was discovered in the 1930s by Felix Bloch (working at Stanford University) and Edward Purcell (from Harvard University).
בתהודה הזו, שדה מגנטי וגלי רדיו גורמים לאטומים לפלוט אותות רדיו זעירים.	In this resonance, magnetic field and radio waves cause atoms to give off tiny radio signals.
בשנת 1970 גילה ריימונד דמאדיאן, רופא וחוקר מדעי, את הבסיס לשימוש בהדמיית תהודה מגנטית ככלי לאבחון רפואי.	In the year 1970, Raymond Damadian, a medical doctor and research scientist, discovered the basis for using magnetic resonance imaging as a tool for medical diagnosis.
ארבע שנים מאוחר יותר ניתן פטנט, שהיה הפטנט הראשון בעולם שהונפק בתחום ה-MRI.	Four years later a patent was granted, which was the world's first patent issued in the field of MRI.
"בשנת 1977, השלים דר דמאדיאן את בנייתו של סורק ה־MRI הראשון של כל-הגוף, אותו כינה הבלתי מנוצח."	In 1977, Dr. Damadian completed the construction of the first “whole-body” MRI scanner, which he called the ”Indomitable”.
נתונים נוירוביולוגיים מספקים ראיות פיזיות לגישה תאורטית לחקר ההכרה. לכן זה מצמצם את תחום המחקר ועושה אותו למדויק יותר.	Neurobiological data provide physical evidence for a theoretical approach to the investigation of cognition. Therefore it narrows the research area and makes it much more exact.
המתאם בין פתולוגיה מוחית והתנהגות תומך במדענים במחקר שלהם.	The correlation between brain pathology and behaviour supports scientists in their research.
מזמן ידוע שסוגים שונים של נזק מוחי, טראומה, פציעות וגידולים משפיעים על התנהגות וגורמים שינויים בתפקודים מנטליים מסוימים.	It has been known for a long time that different types of brain damage, traumas, lesions, and tumours affect behaviour and cause changes in some mental functions.
הופעתן של טכנולוגיות חדשות מאפשרת לנו לראות ולחקור מבנים ותהליכים מוחיים שלא נראו בעבר.	The rise of new technologies allows us to see and investigate brain structures and processes never seen before.
הדבר מספק לנו מידע וחומר רבים הדרושים לבניית מודלים מדמים, אשר עוזרים לנו להבין תהליכים בתודעה שלנו.	This provides us with a lot of information and material to build simulation models which help us to understand processes in our mind.
למרות שבינה מלאכותית מעלה קונוטציה חזקה של מדע בדיוני, היא מהווה ענף חשוב ביותר של מדעי המחשב, העוסק בהתנהגות, למידה והסתגלות תבונית של מכונות.	Although AI has a strong connotation of science fiction, AI forms a very important branch of computer science, dealing with behavior, learning and intelligent adaptation in a machine.
מחקר בבינה מלאכותית כולל פיתוח מכונות לצורך אוטומציה של משימות הדורשות התנהגות תבונית.	Research in AI involves making machines to automate tasks that require intelligent behavior.
דוגמאות כוללות שליטה, תכנון וניהול זמנים, היכולת לענות לאבחונים ולשאלות של הלקוח, בנוסף לזיהוי כתב יד, קול ופנים.	Examples include control, planning and scheduling, the ability to answer customer diagnoses and questions, as well as handwriting recognition, voice and face.
דברים כאלה נהפכו לדיסציפלינות נפרדות, שמתמקדות במתן פתרונות לבעיות מהחיים האמיתיים.	Such things have become separate disciplines, which focus on providing solutions to real life problems.
בדרך כלל משתמשים במערכת הבינה המלאכותית בתחומי הכלכלה, רפואה, הנדסה וצבא. כמו כן, היא הותקנה במספר תוכנות למחשבים ביתיים ומשחקי מחשב.	The AI ​​system is now often used in the fields of economics, medicine, engineering and the military, as has been built in several home computer and video game software applications.
