ב-24 לספטמבר 1759, ארתור גינס חתם על הסכם חכירה ל-9,000 שנים עבור מבשלת סיינט ג'יימס גייט בדבלין, אירלנד.	On September 24, 1759, Arthur Guinness signed a 9,000 year lease for the St James' Gate Brewery in Dublin, Ireland.
250 שנה לאחר מכן, גינס התפתחה לכדי עסק בינלאומי אשר מכניס מעל 10 מיליארד יורו (14.7 מיליארד דולר אמריקאי) בכל שנה.	250 years later, Guinness has grown to a global business that turns over 10 billion euros (US$14.7 billion) every year.
"ממול המשחק, חב' קונאמי, נמסר היום לעיתון יפני שהחברה לא תוציא לשוק את המשחק שישה ימים בפלוג'ה."	The game publisher Konami stated today in a Japanese newspaper that they will not be releasing the game Six Days in Fallujah.
"המשחק מבוסס על קרב פלוג'ה השני, קרב אכזרי בין כוחות ארהב ועיראק."	The game is based on the Second Battle of Fallujah, a vicious battle between American and Iraqi forces.
הנוסעים קיבלו מים בזמן שחיכו בחום של 90 מעלות פרנהייט.	Passengers were given water as they waited in 90(F)-degree heat.
"מפקד כוחות הכיבוי סקוט קונס אמר, היה יום חם בסנטה קלרה עם טמפרטורות מעל 90 מעלות."	Fire captain Scott Kouns said, "It was a hot day in the Santa Clara with temperatures in the 90s.
"כל פרק זמן בו אתה לכוד על רכבת הרים צפוי להיות לא נוח בלשון המעטה, ונדרשה לפחות שעה כדי להוריד את האדם הראשון מהמתקן."	Any length of time trapped on a roller coaster would be uncomfortable, to say the least, and it took at least an hour to get the first person off the ride."
ב-1956 עבר סלאניה לשוודיה, וכעבור שלוש שנים החל לעבוד בשירות הדואר השוודי והפך לחרט הראשי שלהם.	In 1956 Słania moved to Sweden, where three years later he began work for the Swedish Post Office and became their chief engraver.
הוא ייצר למעלה מ־1,000 בולים עבור שוודיה ו־28 מדינות אחרות.	He produced over 1,000 stamps for Sweden and 28 other countries.
"עבודותיו ידועות כל כך באיכות ובפירוט שלהן, עד שהוא נמנה עם השמות השגורים בכל בית המעטים ביותר בקרב אספני הבולים. יש המתמחים באיסוף עבודותיו בלבד."	His work is of such recognized quality and detail that he is one of the very few "household names" among philatelists. Some specialize in collecting his work alone.
"הבול ה-1,000 שלו היה הGreat Deeds by Swedish Kings המרהיב מאת דייויד קלוקר אהרנשטרל בשנת 2000, אשר מדורג בספר השיאים של גינס."	His 1,000th stamp was the magnificent "Great Deeds by Swedish Kings" by David Klöcker Ehrenstrahl in 2000, which is listed in the Guinness Book of World Records.
הוא עסק גם בחריטת שטרות עבור מדינות רבות, דוגמאות מהזמן האחרון כוללות דיוקנאות ראשי ממשלות בחזית השטרות הקנדיים החדשים של $5 ו־$100.	He was also engaged in engraving banknotes for many countries, recent examples of his work including the Prime Ministerial portraits on the front of the new Canadian $5 and $100 bills.
אירוסמית' ביטלו את ההופעות הנותרות בסיבוב ההופעות שלהם.	Aerosmith have cancelled their remaining concerts on their tour.
להקת הרוק הייתה אמורה להיות בסיבוב הופעות בארצות הברית ובקנדה עד ה-16 בספטמבר.	The rock band was due to tour the United States and Canada until September 16.
הם ביטלו את סיבוב ההופעות לאחר שהסולן סטיבן טיילר נפצע בנפילה מהבמה במהלך הופעה ב-5 באוגוסט.	They have cancelled the tour after lead singer Steven Tyler was injured after he fell off stage while performing on August 5.
התוכנית החלה בשעה 20:30 בזמן מקומי (15:00 בזמן אוניברסלי מתואם).	The program started at 8:30 p.m. local time (15.00 UTC).
זמרים מפורסמים בכל המדינה הציגו בהאג'נים, או מזמורי דת, לרגלי שרי שיאם.	Famous singers across the country presented bhajans, or devotional songs, to Shri Shyam's feet.
הזמר סאנג'ו שארמה פתח את הערב, ולאחריו עלה ג'אי שנקר צ'אודרי. כמו כן, הוא הציג את chhappan bhog bhajan. הזמר ראג'ו קנדלוואל ליווה אותו.	Singer Sanju Sharma started the evening, followed by Jai Shankar Choudhary. esented the chhappan bhog bhajan as well. Singer, Raju Khandelwal was accompanying him.
ואז התחיל לקה סינג להוביל את שירת הבהג'אנים.	Then, Lakkha Singh took the lead in singing the bhajans.
108 צלחות של צ'פאן בוג (בהינדואיזם, 56 פריטי מאכל שונים, כגון ממתקים, פירות, אגוזים, מנות וכו' המוצעות כמנחה לאל) הוגשו לבאבא שיאם.	108 plates of Chhappan Bhog (in Hinduism, 56 different edible items, like, sweets, fruits, nuts, dishes etc. which are offered to deity) were served to Baba Shyam.
כמו כן, לאקה סינג הציג את chhappan bhog bhajan. הזמר ראג'ו קנדלוואל ליווה אותו.	Lakkha Singh presented the chhappan bhog bhajan as well. Singer, Raju Khandelwal was accompanying him.
