האוטובוס היה בדרכו אל סיקס פלאגס בסנט לואיס, מיזורי, כדי שהלהקה תנגן מול קהל שקנה את כל הכרטיסים מראש.	The bus was headed to Six Flags St. Louis in Missouri for the band to play to a sold-out crowd.
בשעה 01:15 בשבת, לדברי עדי ראייה, עבר האוטובוס באור ירוק כשהמכונית פנתה מולה.	At 1:15 a.m. Saturday, according to witnesses, the bus was going through a green light when the car made a turn in front of it.
החל מהלילה של התשעה באוגוסט עין הסערה של הטייפון מוראקוט הייתה במרחק של כשבעים קילומטר ממחוז פוג'יאן שבסין.	As of the night of August 9, the eye of Morakot was about seventy kilometres away from the Chinese province of Fujian.
"הטייפון צפוי לנוע לכיוון סין במהירות של 11 קמש."	The typhoon is estimated to be moving toward China at eleven kph.
ה-Twin Otter ניסה לנחות אתמול בקוקודה כטיסת PNG אירליינס CG4684, אך הנחיתה כבר בוטלה פעם אחת.	The Twin Otter had been trying to land at Kokoda yesterday as Airlines PNG Flight CG4684, but had aborted once already.
כעשר דקות לפני מועד הנחיתה המתוכנן בגישה השנייה, הוא נעלם.	About ten minutes before it was due to land from its second approach it disapeared.
מקום ההתרסקות אותר היום אך הוא כה בלתי נגיש, עד ששני שוטרים הוצנחו לג'ונגל כדי שילכו ברגל לזירה ויחפשו ניצולים.	The crash site was located today and is so inaccessable that two policemen were dropped into the jungle in order to hike to the scene and seek survivors.
החיפוש התעכב בשל אותו מזג האוויר קשה שגרם לביטול הנחיתה.	The search had been hampered by the same bad weather that had caused the aborted landing.
על פי הדיווחים, דירה ברחוב מקבת התפוצצה עקב דליפת גז.	According to reports, an apartment on Macbeth Street exploded due to a gas leak.
גורם רשמי בחברת הגז הגיע למקום לאחר ששכן התקשר בנוגע לדליפת גז.	An official with the gas company was reporting to the scene after a neighbor called about a gas leak.
כשהנציג הרשמי הגיע, הדירה התפוצצה	When the official arrived, the apartment exploded.
לא דווחו פציעות חמורות, אך לפחות חמישה אנשים שהיו בזירת האירוע בזמן הפיצוץ קיבלו טיפול לסימפטומים של הלם.	No major injuries were reported, but at least five people on scene at the time of the explosion were treated for symptoms of shock.
לא היה איש בתוך הדירה.	No one was inside the apartment.
באותו זמן, קרוב ל-100 דיירים פונו מן האזור.	At the time, nearly 100 residents were evacuated from the area.
לפחות 100 אנשים נכחו במסיבה, על מנת לחגוג את יום השנה הראשון של זוג אשר חתונתם התרחשה בשנה שעברה.	At least 100 people had attended the party, in order to celebrate the first anniversary of a couple whose wedding was held last year.
אירוע יום זיכרון רשמי נדחה למועד מאוחר יותר, אמרו גורמים רשמיים.	A formal anniversary event was scheduled for a later date, officials said.
הזוג נישא לפני כשנה בטקסס והגיע לבאפלו לחגוג עם חברים וקרובי משפחה.	The couple had married in Texas one year ago and came to Buffalo to celebrate with friends and relatives.
הבעל, בן 30, שנולד בבאפלו, היה אחד מארבעת הרוגי הירי, אולם אשתו לא נפגעה.	The 30-year-old husband, who was born in Buffalo, was one of the four killed in the shooting, but his wife was not hurt.
הסופה הטרופית דניאל, הסופה הרביעית בעלת שם לעונת ההוריקנים האטלנטיים של 2010, נוצרה באוקיינוס האטלנטי המזרחי.	Tropical Storm Danielle, fourth named storm of the 2010 Atlantic hurricane season, has formed in the eastern Atlantic Ocean.
"הסופה, הממוקמת 3,000 מייל בערך ממיאמי שבפלורידה, כוללת רוחות מתמשכות מקסימליות של 40 מייל לשעה (64 קמש)."	The storm, located approximately 3,000 miles from Miami, Florida, has maximum sustained winds of 40 mph (64 kph).
מדענים במרכז ההוריקנים הלאומי חוזים כי דניאל תגדל לכדי הוריקן עד יום רביעי.	Scientists at the National Hurricane Center predict that Danielle will strengthen to a hurricane by Wednesday.
מכיוון שהסופה רחוקה מלהגיע ליבשה, עדיין קשה להעריך את הפגיעה הפוטנציאלית שלה בארצות הברית או בקריביים.	As the storm is far from landfall, it remains difficult to assess potential impact to the United States or Caribbean.
פיטר לנץ, נהג מירוצי אופנועים בן 13, מת לאחר שהיה מעורב בתאונה במסלול המירוצים של אינדיאנפוליס.	Peter Lenz, a 13-year-old motorcycle racer, has died after being involved in a crash at the Indianapolis Motor Speedway.
בעת הקפת החימום שלו, נפל לנץ מהאופנוע שלו, ואז נפגע ממשתתף אחר במרוץ חאבייר זאייט.	While on his warm-up lap, Lenz fell off his bike, and was then struck by fellow racer Xavier Zayat.
הוא טופל מיידית בידי הצוות הרפואי שנמצא במקום והועבר לבית חולים מקומי שם נפטר מאוחר יותר.	He was immediately attended to by the on-track medical staff and transported to a local hospital where he later died.
זיאת לא נפגע בתאונה.	Zayat was unhurt in the accident.
על פי דף המידע האחרון, קריאות מפלס הים הצביעו על היווצרות צונמי. פעילות צונמי ודאית מסוימת נרשמה ליד פאגו פאגו וניואה.	According to the latest bulletin, sea level readings indicated a tsunami was generated. There was some definite tsunami activity recorded near Pago Pago and Niue.
לא דווח על נזקים רציניים לגוף ולרכוש בטונגה, אך נגרמה הפסקת חשמל זמנית, אשר לפי הדיווחים מנעה מרשויות טונגה לקבל את אזהרת הצונאמי שהוציא ה־PTWC.	No major damage or injuries have been reported in Tonga, but power was temporarily lost, which reportedly prevented Tongan authorities from receiving the tsunami warning issued by the PTWC.
ארבעה-עשר בתי ספר בהוואי הממוקמים על קו החוף או בסמוך לו היו סגורים לכל אורך רביעי למרות הסרת ההתרעות.	Fourteen schools in Hawaii located on or near coastlines were closed all of Wednesday despite the warnings being lifted.
תאונות אוויר הן שכיחות באיראן, שצי המטוסים שלה מתיישן ומתוחזק בצורה גרועה למבצעים אזרחיים וצבאיים כאחד.	Air accidents are common in Iran, which has an aging fleet that is poorly maintained both for civil and military operations.
בשל סנקציות בינלאומיות, כלי הטיס החדש אינו ניתן לרכישה.	International sanctions have meant that new aircraft cannot be purchased.
מוקדם יותר השבוע, התרסקות מסוק משטרתי הרגה שלושה אנשים ופצעה שלושה נוספים.	Earlier this week, a police helicopter crash killed three people and wounded three more.
בחודש שעבר ספגה איראן את האסון האווירי הקשה ביותר מזה שנים כשמטוס שהיה בדרכו לארמניה התרסק וגרם למותם של 168 נוסעיו.	Last month Iran saw its worst air disaster in years when an airliner heading to Armenia crashed, killing the 168 on board.
באותו חודש נראה מטוס אחר שגלש מהמסלול במשהד (Mashhad), פגע בקיר והרג שבעה עשר.	The same month saw another airliner overrun a runway at Mashhad and strike a wall, killing seventeen.
רעידת האדמה פגעה במריאנה ב-07:19 זמן מקומי (21:19  לפי שעון גריניץ' יום שישי).	The eathquake struck Mariana at 07:19 a.m. local time (09:19 p.m. GMT Friday).
מלשכת ניהול מצבי חירום באיי מריאנה הצפוניים נמסר שלא דווח על נזקים במדינה.	The Northern Marianas emergency management office said that there were no damages reported in the nation.
גם מרכז ההתראות מפני צונאמי באוקיינוס השקט אמר כי לא היו סימנים לצונאמי.	Also the Pacific Tsunami Warning Center said that there was no Tsunami indication.
"סוכנות הידיעות שינחואה דיווחה שחוקרי הממשל מצאו ביום רביעי שני מכשירי הקלטה של טיסות מסוג קופסאות שחורות."	Xinhua reported that government investigators recovered two 'black box' flight recorders on Wednesday.
