גאות אדומה נגרמת על ידי ריכוז גבוה מהרגיל של Karenia brevis, אורגניזם ימי חד-תאי טבעי.	Red tide is caused by a higher than normal concentration of Karenia brevis, a naturally-occurring single-celled marine organism.
גורמים טבעיים יכולים להצטלב ליצירת תנאים אידאליים, המאפשרים לאצות אלה לעלות דרמטית במספרן.	Natural factors can intersect to produce ideal conditions, allowing this algae to increase in number dramatically.
האצות מייצרות רעלן עצבי שעלול לנטרל עצבים בבני אדם ודגים כאחד.	The algae produces a neurotoxin that can disable nerves in both humans and fish.
דגים מתים פעמים רבות גלל הריכוזים הגבוהים של הרעלן במים.	Fish often die because of the high concentrations of the toxin in the waters.
בני אדם יכולים להיפגע מנשימת של מים נגועים שמועלים לאוויר על ידי רוח וגלים.	Humans can be affected by breathing affected water taken into the air by wind and waves.
בשיאו, הציקלון הטרופי גונו, שנקרא על שם שק עלי עץ דקל בשפה המלדיבית, הגיע לרוחות מתמשכות במהירות של 240 קילומטר בשעה (149 מייל בשעה).	At its peak, Tropical Cyclone Gonu, named for a bag of palm leaves in the language of the Maldives, reached sustained winds of 240 kilometers an hour (149 miles per hour) .
"היום, בשעת בוקר מוקדמת, נשבו רוחות של כ-83 קמש, והן היו צפויות להיחלש."	By early today, winds were around 83 km/h, and it was expect to keep weakening.
על סיפון הלונו היו 120-160 מטרים רבועים של דלק כשהיא נשברה והרוחות החזקות והגלים דחפו אותה אל שובר הגלים.	The Luno had 120–160 cubic metres of fuel aboard when it broke down and high winds and waves pushed it into the breakwater.
מסוקים חילצו את שנים-עשר אנשי הצוות והפציעה היחידה הייתה אף שבור.	Helicopters rescued the twelve crewmembers and the only injury was a broken nose.
הספינה באורך 100 המטרים הייתה בדרך לאסוף את מטעני הדשנים הרגילים שלה, ובתחילה חששו גורמים רשמיים שהתכולה עלולה להישפך מהספינה.	The 100-metre ship was en route to pick up its usual fertiliser cargo and initially officials feared the vessel could spill a load.
"אנו נעשה מאמץ לצמצם את פליטת הפחמן הדו-חמצני ליחידת תלג עד 2020 בהפרש ניכר לעומת רמת הפליטה ב-2005, אמר הו."	"We will endeavour to cut carbon dioxide emissions per unit of GDP by a notable margin by 2020 from the 2005 level," Hu said.
הוא לא קבע שיעור לקיצוצים, בטענה שהוא יוחלט על בסיס התפוקה הכלכלית של סין.	He did not set a figure for the cuts, saying they will be made based on China's economic output.
"הו עודד מדינות מתפתחות להימנע מדרך הפעולה הישנה שבה קודם מזהמים ואחר כך מנקים."	Hu encouraged developing countries "to avoid the old path of polluting first and cleaning up later."
"הוא הוסיף, כי עם זאת, אין לבקש מהם לקחת על עצמם התחייבויות החורגות משלב ההתפתחות, האחריות והיכולות שלהם."	He added that "they should not, however, be asked to take on obligations that go beyond their development stage, responsibility and capabilities."
רעידת אדמה מתונה הורגשה במערב מונטנה בשעה 22:08  ביום שני.	A moderate earthquake shook western Montana at 10:08 p.m. on Monday.
לא התקבלו דיווחים מידיים על נזק בסקר הגאולוגי של ארצות הברית (USGS) ובמרכז הלאומי למידע על רעידות אדמה.	No immediate reports of damage have been received by the United States Geological Survey (USGS) and its National Earthquake Information Center.
"מרכז רעידת האדמה היה בערך 20 קמ (15 מיילים) מצפון-צפון-מזרח לדילון (Dillon), ובערך 65 קמ (40 מיילים) דרומית לבוט (Botte)."	The earthquake was centered about 20 km (15 miles) north-northeast of Dillon, and about 65 km (40 miles) south of Butte.
"חמש דקות מתחילת התצוגה הרוח החלה לנשוב פנימה, כדקה לאחר מכן, הרוח הגיעה ל -70 קמש... ואז הגשם בא, אבל כל כך חזק וכל כך גדול שהוא פוגע בעור כמו מחט, ואז ברד נפל מהשמיים, אנשים מבוהלים וצועקים ורומסים זה את זה."	Five minutes into the display a wind starts rolling in, about a minute later, the wind is reaching 70km/h... then the rain comes, but so hard and so large that it slaps your skin like a needle, then hail fell from the sky, people panicking and screaming and running over each other.
"איבדתי את אחותי ואת החבר שלה, ובדרכי לשם היו שני נכים בכיסאות גלגלים ואנשים פשוט קפצו מעליהם ודחפו אותם, אמר ארמנד ורסצ'ה."	I lost my sister and her friend, and on my way there were two disabled people in wheelchairs, people just jumping over and pushing them," Armand Versace said.
NHK דיווחה בנוסף כי תחנת הכוח הגרעינית קאשיווזאקי קאריווה במחוז ניגאטה תפקדה באופן תקין.	NHK also reported that the Kashiwazaki Kariwa nuclear power plant in Niigata prefecture was operating normally.
חברת החשמל של הוקוריקו דיווחה כי לא היו השפעות לרעידת האדמה וכי הכורים מספר 1 ו-2 בתחנת הכוח הגרעינית שלה שיקה הושבתו.	Hokuriku Electric Power Co. reported no effects from the earthquake and that the Number 1 and 2 reactors at its Shika nuclear power plant were shut down.
דווח כי ש-9400 בתים באזור נשארו ללא מים וכ-100 ללא חשמל.	It is reported that some 9400 homes in the region are without water and approximately 100 without electricity.
כבישים ניזוקו, שירות הרכבות שובש באזורים שנפגעו, ונמל התעופה נוטו במחוז אישיקאווה נותר סגור.	Some roads have been damaged, railway service interrupted in the affected areas, and the Noto Airport in Ishikawa prefecture remains closed.
