ביום שני, מדענים מבית הספר לרפואה באוניברסיטת סטנפורד הכריזו על המצאת אמצעי אבחון חדש אשר מסוגל למיין תאים לפי סוג: שבב זעיר הניתן להדפסה שאפשר לייצר באמצעות מדפסות הזרקת דיו סטנדרטיות בעלות של בערך סנט אמריקאי אחד לכל פריט.	On Monday, scientists from the Stanford University School of Medicine announced the invention of a new diagnostic tool that can sort cells by type: a tiny printable chip that can be manufactured using standard inkjet printers for possibly about one U.S. cent each.
חוקרים מובילים אומרים כי הדבר עשוי להביא לגילוי מוקדם של סרטן, שחפת, HIV ומלריה לחולים במדינות מתפתחות, היכן ששיעורי ההישרדות ממחלות כמו סרטן השד יכולים להיות חצי מבמדינות עשירות יותר.	Lead researchers say this may bring early detection of cancer, tuberculosis, HIV and malaria to patients in low-income countries, where the survival rates for illnesses such as breast cancer can be half those of richer countries.
ממשלת אירלנד מדגישה את דחיפות החקיקה הפרלמנטרית כדי לתקן את המצב.	The Irish government is stressing the urgency of parliamentary legislation to rectify the situation.
"לדברי דובר מטעם הממשלה, כעת חשוב שהחקיקה תתבצע מהר ככל הניתן, הן מבחינת הדין הפלילי והן מבחינת בריאות הציבור."	"It is now important from both a public health and criminal justice perspective that the legislation be enacted as soon as possible", said a government spokesperson.
שר הבריאות הביע דאגה הן לרווחתם של אנשים שמנצלים את החוקיות הזמנית של החומרים המדוברים, והן לגבי הרשעות בעבירות סמים שהתקבלו מאז נכנסו לתוקף השינויים הבלתי חוקתיים.	The Health Minister expressed concern both for the welfare of individuals taking advantage of the temporary legality of the substances involved, and for drug-related convictions handed down since the now-unconstitutional changes came into effect.
נדיה, שנולדה ב-17 בספמטבר 2007, בניתוח קיסרי במחלקת היולדות באלייסק, רוסיה, נולדה במשקל העצום של 17 ליטרות ואונקיה אחת.	Nadia, born on September 17, 2007, by Cesarean section at a maternity clinic in Aleisk, Russia, weighed in at a massive 17 pounds 1 ounce.
"כולנו היינו פשוט בהלם, סיפרה האם."	"We were all simply in shock," the mother stated.
"כשנשאלה מה אמר האב, השיבה, הוא לא היה יכול לומר כלום - הוא סתם עמד ומצמץ בעיניים."	When asked what the father said, she answered "He couldn't say a thing - he just stood there blinking."
"דר לי גם הביע את חששותיו בנוגע לדיווחים שילדים בטורקיה נדבקו כעת בנגיף שפעת העופות (A (H5N1 מבלי להיות חולים במחלה."	Dr. Lee also expressed his concern about reports that children in Turkey have now become infected with the A(H5N1) avian influenza virus without becoming ill.
כמה מחקרים מציעים כי המחלה חייבת להפוך לפחות קטלנית לפני שהיא יכולה לגרום למגפה עולמית, הוא ציין.	Some studies suggest that the disease must become less lethal before it can cause a global epidemic, he noted.
ישנו חשש כי חולים עלולים להמשיך ולהדביק אנשים נוספים אם ימשיכו בשגרת היום יום שלהם אם תסמיני השפעת נשארים קלים.	There is concern that patients may continue to infect more people by going through their daily routines if the flu symptoms remain mild.
הכינו וקחו איתכם עותקים של הפוליסה שלכם ושל פרטי הקשר של חברת הביטוח.	Make and carry copies of your policy and your insurer's contact details with you.
הם צריכים להראות את כתובת האימייל של חברת הביטוח ומספרי הטלפון הבינלאומיים לייעוץ/הרשאות וכדי להגיש תביעות.	They need to show the insurer's e-mail address and international phone numbers for advice/authorizations and making claims.
"שמרו עותק נוסף במזוודה שלכם ובאופן מקוון (שלחו דואר אלקטרוני לעצמכם עם קובץ מצורף, או שמרו בענן)."	Have another copy in your luggage and online (e-mail to yourself with attachment, or stored in the "cloud").
אם אתם מטיילים עם מחשב נייד או מחשב לוח (טאבלט), אחסנו עותק בזיכרון או בדיסק שלו (נגיש ללא אינטרנט).	If traveling with a laptop or tablet, store a copy in its memory or disc (accessible without the internet).
כמו כן, תנו עותקים של הפוליסה/פרטי התקשרות לחברים לנסיעה ולקרובי משפחה או חברים בבית שמוכנים לעזור.	Also give policy/contact copies to traveling companions and relatives or friends back home willing to help.
בעוד שנראה שחיסון ניסיוני אחד יכול לצמצם 9את התמותה מאבולה, עד כה לא נמצאו תרופות שהוכח שהן מתאימות לטפל בזיהום קיים.	While one experimental vaccine appears able to reduce Ebola mortality, up until now, no drugs have been clearly demonstrated suitable for treating existing infection.
קוקטייל נוגדנים אחד, ZMapp, הראה בתחילה פוטנציאל מבטיח בתחום, אבל מחקרים רשמיים הצביעו על כך שיש בו פחות תועלת במניעת מוות מאשר רצו.	One antibody cocktail, ZMapp, initially showed promise in the field, but formal studies indicated it had less benefit than sought in preventing death.
בניסוי PALM, שימש ZMapp כביקורת, כלומר, מדענים השתמשו בו כקו הבסיס והשוו אליו את שלושת הטיפולים האחרים.	In the PALM trial, ZMapp served as a control, meaning scientists used it as a baseline and compared the three other treatments to it.
"דר טוני מול גילה את השחפת בעלת העמידות הקיצונית לתרופות (XDR-TB) באזור קווהזולו־נאטאל בדרום אפריקה."	Dr. Tony Moll discovered the Extremely Drug Resistant Tuberculosis (XDR-TB) in the South African region KwaZulu-Natal.
"הוא אמר בראיון כי הוריאציה החדשה מטרידה ומדאיגה מאוד בגלל שיעור התמותה המאוד גבוה."	In an interview, he said the new variant was "very highly troubling and alarming because of the very high fatality rate."
"דר מול חושב כי כמה מהחולים נדבקו בחיידק בבית החולים, ולפחות שניים היו מצוותי הרפואה של בית החולים."	Some patients might have contracted the bug in the hospital, Dr. Moll thinks, and at least two were hospital health workers.
במהלך שנה אחת, אדם נגוע עלול להדביק 10 עד 15 אנשים קרובים.	In one year's time, an infected person may infect 10 to 15 close contacts.
עם זאת, אחוז החולים ב־XDR-TB מתוך כלל החולים בשחפת עדיין נראה נמוך; 6,000 מתוך 330,000 חולים בכל רגע נתון בדרום אפריקה.	However, the percentage of XDR-TB in the entire group of people with tuberculosis still seems to be low; 6,000 of the total 330,000 people infected at any particular moment in South Africa.
מקריה הראשונים של המחלה בעונה הנוכחית דווחו בסוף יולי.	The first cases of the disease this season were reported in late July.
המחלה נישאת על ידי חזירים, ולאחר מכן עוברת לבני אדם באמצעות יתושים.	The disease is carried by pigs, which then migrates to humans through mosquitos.
ההתפרצות הניעה את ממשלת הודו לנקוט אמצעים כמו פיזור מלכודות חזירים באזורים שנפגעו באופן חמור, חלוקת אלפי כילות נגד יתושים וריסוס חומרי הדברה.	The outbreak has prompted the Indian government to undertake such measures as deployment of pig catchers in seriously affected areas, distributing thousands of mosquito curtains and spraying pesticides.
הממשלה הבטיחה גם כמה מיליוני מנות של חיסון לדלקת המוח, מה שיסייע להכין את ארגוני הבריאות לשנה הבאה.	Several million vials of encephalitis vaccine have also been promised by the government, which will help prepare health agencies for next year.
התוכניות לשלוח השנה חיסונים לאזורים שבעבר נפגעו באופן הקשה ביותר נדחו עקב היעדר תקציב ותעדוף נמוך ביחס למחלות אחרות.	Plans for vaccines to be delivered to the historically most affected areas this year were delayed due to lack of funds and low prioritisation relative to other diseases.
פלוק כתבה שהמאמצים של כמה אנשים להשתיק נשים מלדבר על בריאותן של נשים לא צלחו.	Fluke wrote that the efforts by some to drown out women from speaking out about women’s health were unsuccessful.
היא הגיעה למסקנה הזו בשל שלל ההערות החיוביות והעידוד שנשלחו אליה הן על־ידי נשים והן על־ידי גברים שקראו להחשיב תרופות נגד הריון כצורך רפואי.	She came to this conclusion due to the multitude of positive comments and encouragement sent to her by both female and male individuals urging that contraception medication be considered a medical necessity.
לדברי ארגון הצדקה הרפואי מנגולה, רופאים ללא גבולות וארגון הבריאות העולמי, מדובר בהתפרצות הקשה ביותר שתועדה במדינה.	The medical charity Mangola, Medecines Sans Frontieres and the World Health Organisation say it is the worst outbreak recorded in the country.
"ריצ'רד ורמן, דובר מטעם רופאים ללא גבולות, אמר: אנגולה בדרך להתפרצות הגרועה ביותר בה אי פעם והמצב נותר רע מאוד באנגולה, הוא אמר."	Spokesman for Medecines Sans Frontiere Richard Veerman said: "Angola is heading for its worst ever outbreak and the situation remains very bad in Angola," he said.
אושר שזן שפעת העופות הקטלני לבני אדם, H5N1, זוהה בברווז בר מת, שנמצא ביום שני בביצה ליד ליון שבמזרח צרפת.	The strain of bird flu lethal to humans, H5N1, has been confirmed to have infected a dead wild duck, found on Monday, in marshland near Lyon in the east of France.
צרפת היא המדינה השביעית באיחוד האירופי שסובלת מנגיף זה; אחרי אוסטריה, גרמניה, סלובניה, בולגריה, יוון ואיטליה.	France is the seventh country in the European Union to suffer this virus; following Austria, Germany, Slovenia, Bulgaria, Greece and Italy.
חשד למקרים של שפעת העופות (H5N1) בקרואטיה ודנמרק נותר לא מאומת.	Suspected cases of H5N1 in Croatia and Denmark remain unconfirmed.
המילטון אישר כי המטופל הגיע לבית החולים באוניברסיטת הווארד במצב יציב.	Hamilton confirmed Howard University Hospital admitted the patient in stable condition.
החולה היה בניגריה, שם התרחשו מספר מקרים של נגיף האבולה.	The patient had been to Nigeria, where some cases of the Ebola virus have occurred.
בית החולים פעל על פי פרוטוקול למניעת זיהומים, כולל הפרדת המטופל מאחרים כדי למנוע הדבקה אפשרית.	The hospital has followed protocol for infection control, including separating the patient from others to prevent possible infection of others.
