בחום היום המטיילים יכולים לחוות חזיונות תעתועים הנותנים אשליה של מים (או דברים אחרים).	In the heat of the day, travelers can experience mirages that give the illusion of water (or other things).
אלו עלולים להיות מסוכנים אם המטייל רודף אחר התעתוע, ותוך כך, מבזבז אנרגיה יקרה ואת אספקת המים שנשארה.	These can be dangerous if the traveler pursue the mirage, wasting precious energy and remaining water.
אפילו המדבר החם ביותר יכול להפוך לקר באופן קיצוני בלילה. היפותרמיה היא סכנה אמיתית ללא ביגוד חם.	Even the hottest of deserts can become extremely cold at night. Hypothermia is a real risk without warm clothing.
במיוחד בקיץ, תצטרכו להישמר מיתושים אם תחליטו לעשות הליכה ביער הגשם.	In summer, especially, you'll need to watch out for mosquitoes if you decide to hike through the rainforest.
גם אם אתם נוהגים דרך יער הגשם הסובטרופי, כמה שניות עם הדלתות פתוחות בזמן שאתם נכנסים לרכב זה מספיק זמן ליתושים כדי להיכנס לרכב איתכם.	Even if you're driving through the subtropical rainforest, a few seconds with the doors open while you get inside the vehicle is enough time for mosquitoes to get in the vehicle with you.
שפעת העופות, או בשמה הרשמי avian influenza, יכולה להדביק הן עופות והן יונקים.	Bird flu, or more formally avian influenza, can infect both birds and mammals.
פחות מאלף מקרים דווחו אי פעם בבני אדם, אך חלקם היו קטלניים.	Fewer than a thousand cases have ever been reported in humans, but some of them have been fatal.
ברוב המקרים הללו היו מעורבים אנשים שעובדים עם עופות, אך קיים סיכון מסוים גם לצפרים.	Most have involved people who work with poultry, but there is also some risk to birdwatchers.
מאפיינים טיפוסיים של נורווגיה הם פיורדים ועמקים תלולים שנהפכים לפתע למישורים גבוהים, שטוחים יותר או פחות.	Typical for Norway are steep fjords and valleys that suddenly give way to a high, more or less even plateau.
"המישורים האלו נקראים לעתים קרובות vidde כלומר אזור רחב ופתוח, מחוסר עצים, מרחב ללא גבולות."	These plateaus are often referred to as "vidde" meaning a wide, open treeless space, a boundless expanse.
"ברוגלנד ואגדר הן בדרך כלל נקראות hei כלומר אדמת בור חסרת עצים המכוסה לעתים קרובות באברש."	In Rogaland and Agder they are usually called "hei" meaning a treeless moorland often covered in heather.
הקרחונים אינם יציבים, אלא זורמים במורד ההרים. דבר זה יגרום לסדקים, בקיעים, שעלולים להסתתר מאחורי גשרי שלג.	The glaciers are not stable, but flow down the mountain. This will cause cracks, crevasses, which may be obscured by snow bridges.
הקירות תקרות של מערות קרח יכולים לקרוס וסדקים יכולים להיסגר.	The walls and roofs of ice caves can collapse and cracks can get closed.
מקצות הקרחונים מתנתקים גושי ענק, נופלים מטה ולפעמים קופצים או מתגלגלים רחוק יותר מהקצה.	At the edge of glaciers huge blocks break loose, fall down and perhaps jump or roll farther from the edge.
שיא עונת התיירות לתחנות ההרריות הוא בדרך כלל בזמן הקיץ ההודי.	The tourist season for the hill stations generally peaks during the Indian summer.
עם זאת, יש להם סוג אחר של יופי וקסם במהלך החורף, כאשר כמויות יפות של שלג יורדות על תחנות גבעה רבות ואלו מציעות פעילויות כמו סקי וסנובורד.	However, they have a different kind of beauty and charm during winter, with many hill stations receiving healthy amounts of snow and offering activities such as skiing and snowboarding.
מצפים פרה-מודרניים כיום הם בדרך כלל מיושנים, ונותרו כמוזאונים או אתרים חינוכיים.	Pre-modern observatories are usually obsolete today, and remain as museums, or sites of education.
מכיוון שזיהום אור בימי השיא שלהם לא היה בעיה כפי שהוא היום, הם בדרך כלל ממוקמים בערים או בקמפוסים, קלים יותר להגעה מאשר אלה שנבנו בתקופה המודרנית.	As light pollution in their heyday was not the kind of problem it is today, they are usually located in cities or at campuses, easier to reach than those built in modern times.
רוב הטלסקופים המחקריים המודרניים הם מתקנים ענקיים שנמצאים באזורים נידחים עם תנאים אטמוספריים חיוביים.	Most modern research telescopes are enormous facilities in remote areas with favorable atmospheric conditions.
צפייה בפריחת הדובדבן, הידועה בשם הנאמי, הייתה חלק מהתרבות היפנית מאז המאה השמינית לספירה.	Cherry blossom viewing, known as hanami, has been a part of Japanese culture since the 8th century.
הרעיון הגיע מסין, שם פריחות השזיף היו הפרח הנבחר.	The concept came from China where plum blossoms were the flower of choice.
ביפן אירח הקיסר את מסיבות פריחת הדובדבן רק עבור עצמו ועבור חברי אצולה אחרים סביב חצר הקיסר.	In Japan, the first cherry blossom parties were hosted by the emperor only for himself and other members of the aristocracy around the Imperial Court.
"צמחים נראים במיטבם בסביבה טבעית, לכן התאפקו מלקטוף אפילו רק פרח אחד."	Plants look their best when in a natural environment, so resist the temptation to remove even "just one" specimen.
"כאשר אתם מבקרים בגן רשמי, קטיפת דגימות תגרום לסילוקכם מהמקום ללא דיון."	If visiting a formally arranged garden, collecting "specimens" is also going to get you ejected, without discussion.
סינגפור היא בדרך כלל מקום בטוח מאוד להיות בו וקול מאוד לנווט בה, וניתן לקנות כמעט כל דבר לאחר ההגעה.	Singapore is generally an extremely safe place to be and very easy to navigate, and you can buy almost anything after arriving.
"אך כשאתם ממוקמים באזורים הטרופיים הגבוהים כמה מעלות צפונה לקו המשווה, תצטרכו להתמודד גם עם חום (תמיד) וגם עם שמש חזקה (כשהשמיים בהירים, נדיר יותר)."	But being placed in the "high tropics" just a few degrees north of equator you will need to deal with both heat (always) and strong sun (when the sky is clear, more rarely).
יש גם כמה אוטובוסים שנוסעים צפונה לחברון, מקום קבורתם המסורתי של האבות המקראיים אברהם, יצחק ויעקב, ושל נשותיהם.	There are also a few buses going north to Hebron, the traditional burial place of the Biblical patriarchs Abraham, Isaac, Jacob, and their wives.
בדקו שהאוטובוס שאתם שוקלים לנסוע בו נכנס לחברון ולא רק להתנחלות היהודית הסמוכה קריית ארבע.	Check that the bus you are thinking of taking goes into Hebron and not just to the nearby Jewish settlement of Kiryat Arba.
נתיבי מים פנים-יבשתיים יכולים להיות נושא טוב שאפשר לבסס סביבו חופשה.	Inland waterways can be a good theme to base a holiday around.
למשל, ביקור בטירות בעמק הלואר, בעמק הריין או שיט לאתרים מעניינים על הדנובה או שיט לאורך תעלת אירי.	For example visiting castles in the Loire Valley, the Rhine valley or taking a cruise to interesting cites on the Danube or boating along the Erie Canal.
בנוסף, הם מגדירים נתיבים למסלולי הליכה ורכיבה פופולריים.	They also define routes for popular hiking and cycling trails.
כל בעלי החיים שהגיעו במקור אל האיים הגיעו לכאן בשחייה, בתעופה או בציפה.	All animals that originally arrived in the islands came here either by swimming, flying or floating.
בגלל המרחק הרב מהיבשת, לא יכלו יונקים לעשות את המסע, מה שהפך את הצב הענק לחיית המרעה העיקרית בגלאפגוס.	Due to the long distance from the continent mammals were unable to make the journey making the giant tortoise the primary grazing animal in the Galapagos.
מאז הגעת האדם לאיי הגלאפאגוס, יונקים רבים הובאו לאי, ביניהם עזים, סוסים, פרות, עכברושים, חתולים וכלבים.	Since the arrival of man to the Galapagos, many mammals have been introduced including goats, horses, cows, rats, cats and dogs.
אם תבקרו בקוטב הצפוני או הדרומי בחורף תחוו ליל קוטב, שפירושו שהשמש לא עולה מעל קו האופק.	If you visit the Arctic or Antarctic areas in the winter you will experience the polar night, which means that the sun doesn't rise above the horizon.
זה נותן הזדמנות טובה לראות את הזוהר הצפוני, היות והשמים יהיו כהים פחות או יותר במשך כל שעות היממה.	This offers a good opportunity to see the Aurora borealis, as the sky will be dark more or less around the clock.
מכיוון שהאזורים מאוכלסים בדלילות, ולכן זיהום אור לרוב אינו בעיה, תוכלו גם ליהנות מהכוכבים.	As the areas are sparsely populated, and light pollution therefore often not a problem, you will also be able to enjoy the stars.
