המחאה החלה בערך ב-11:00, זמן מקומי (UTCּ+1), בווייטהול, מול הכניסה לרחוב דאונינג השמורה על ידי שוטרים, המשכן הרשמי של ראש הממשלה.	The protest started around 11:00 local time (UTC+1) on Whitehall opposite the police-guarded entrance to Downing Street, the Prime Minister's official residence.
מעט לאחר השעה 11:00, המפגינים חסמו את התנועה צפונה ברחוב וייטהול.	Just after 11:00, protesters blocked traffic on the northbound carriage in Whitehall.
בשעה 11:20, המשטרה ביקשה מהמפגינים לנוע חזרה למדרכה בטענה כי עליהם לאזן בין זכות המחאה לבין עומס התנועה.	At 11:20, the police asked the protesters to move back on to the pavement, stating that they needed to balance the right to protest with the traffic building up.
בסביבות 11:29, המחאה עלתה את ווייטהול, מעבר לכיכר טרפלגר, לאורך הסטרנד, כשהיא עוברת את אלדוויץ' ועולה את קינגסווי לכיוון הולבורן היכן  שהמפלגה השמרנית קיימה את פורום האביב שלה במלון  Grand Connaught Rooms.	Around 11:29, the protest moved up Whitehall, past Trafalgar Square, along the Strand, passing by Aldwych and up Kingsway towards Holborn where the Conservative Party were holding their Spring Forum in the Grand Connaught Rooms hotel.
"מא, שנולד בהונג קונג, למד באוניברסיטת ניו יורק ובבית הספר למשפטים של הרווארד, ובעבר היה לו גרין קארד של תושבות קבע בארהב."	Born in Hong Kong, Ma studied at New York University and Harvard Law School and once held an American permanent resident "green card".
שיי רמז במהלך הבחירות כי מא עלול להימלט מהמדינה בתקופת משבר.	Hsieh implied during the election that Ma might flee the country during a time of crisis.
סייה טען גם כי מא הפוטוגני היה יותר סגנון מאשר תוכן.	Hsieh also argued that the photogenic Ma was more style than substance.
פיטר קוסטלו, גזבר אוסטרלי והיורש הסביר ביותר לראש הממשלה ג'והן האווארד כראש המפלגה הליברלית, נידב את תמיכתו להקמת תחנת כוח גרעינית באוסטרליה.	Peter Costello, Australian treasurer and the man most likely to succeed Prime Minister John Howard as Liberal party leader has thrown his support behind a nuclear power industry in Australia.
מר קוסטלו אמר שכאשר ייצור האנרגיה הגרעינית יהיה מעשי מבחינה כלכלית, אוסטרליה צריכה לחתור להשתמש בה.	Mr Costello said that when nuclear power generation becomes economically viable, Australia should pursue its use.
"אם זה ייעשה מסחרי, עלינו לקבל אותו. כלומר, אין התנגדות עקרונית לאנרגיה גרעינית אמר קוסטלו."	"If it becomes commercial, we should have it. That is, there's no in-principle objection to nuclear energy" Mr Costello said.
רוברטס סירב בתוקף לומר מת בערך החיים מתחילים לדעתו, שאלה חשובה כשדנים באתיקה של הפלות, בטענה שלא יהיה זה אתי להגיב על הפרטים של מקרים אפשריים.	Roberts flatly refused to say about when he believes life begins, an important question when considering the ethics of abortion, saying that it would be unethical to comment on the specifics of likely cases.
"עם זאת, הוא חזר על הצהרתו הקודמת כי פסק הדין רו נגד ווייד הנו חוק המדינה המסודר, והדגיש את החשיבות שבפסיקות עקביות של בית המשפט העליון."	He did, however, reiterate his earlier statement that Roe v. Wade was the "settled law of the land", emphasizing the importance of consistent Supreme Court rulings.
הוא אישר גם שהוא מאמין בזכות המשתמעת לפרטיות שעליה נשענה הכרעת רו.	He also confirmed that he believed in the implied right to privacy which the Roe decision depended upon.
לודין אמר גם כי גורמים רשמיים החליטו לבטל את הסיבוב השני כדי לחסוך לאפגנים את ההוצאות ואת הסיכון הביטחוני שבבחירות נוספות.	Lodin also said officials decided to cancel the runoff in order to save Afghans the expense and security risk of another election.
דיפלומטים אמרו כי הם מצאו מספיק עמימות בחוקה האפגנית כדי לקבוע כי הסיבוב השני מיותר.	Diplomats said that they had found enough ambiguity in the Afghan constitution to determine the runoff as unnecessary.
זה סותר דיווחים קודמים, שלפיהם ביטול סיבוב ההכרעה היה מנוגד לחוקה.	This contradicts earlier reports, which said that cancelling the runoff would have been against the constitution.
התגובות, בשידור חי בטלוויזיה, היו הפעם הראשונה שבה מקורות בכירים באיראן הודו שלסנקציות יש השפעה.	The comments, live on television, were the first time that senior Iranian sources have admitted that the sanctions are having any effect.
הן כוללות הגבלות פיננסיות ואיסור של האיחוד האירופי על ייצוא נפט גולמי, שאחראי ל-80% מהכנסות הזרות של המשק האיראני.	They include financial restrictions and a ban by the European Union on the export of crude oil, from which the Iranian economy receives 80% of its foreign income.
"בדוח החודשי האחרון של אופק, צוין כי ייצוא הנפט גולמי ירד לרמתו הנמוכה ביותר מזה שני עשורים ועומד על 2.8 מיליון חביות ליום."	In its most recent monthly report, OPEC said exports of crude had fallen to their lowest level for two decades at 2.8 million barrels per day.
"המנהיג העליון של המדינה, אייתוללה עלי ח'אמנאי, תיאר את התלות בנפט כמלכודת שהתחילה לפני המהפכה האיסלאמית באיראן ב-1979 ושהמדינה צריכה להשתחרר ממנה."	The country's supreme leader, Ayatollah Ali Khamenei, has described the dependency on oil as "a trap" dating from before Iran's Islamic revolution in 1979 and from which the country should free itself.
רשות השידור האוסטרלית (ACMA) מצאה גם כי למרות שהווידיאו שודר באינטרנט, האח הגדול לא הפר את חוקי הצנזורה על תוכן מקוון שכן המדיה לא אוחסנה באתר האינטרנט של האח הגדול.	The ACMA also found that despite the video being streamed on the Internet, Big Brother had not breached online content censorship laws as the media had not been stored on Big Brother's website.
חוק שירותי השידור מסדיר את התוכן באינטרנט, אולם, כדי כדי להיחשב ככתוכן אינטרנט, עליו לשכון פיזית בשרת.	The Broadcasting Services Act provides for the regulation of Internet content, however to be considered Internet content, it must physically reside on a server.
"שגרירות ארצות הברית הממוקמת בניירובי, קניה פרסמה אזהרה לפיה קיצונים מסומליה מתכננים פיגועי התאבדות בקניה ובאתיופיה."	The United States embassy located in Nairobi, Kenya has issued a warning that "extremists from Somalia" are planning to launch suicide bomb attacks in Kenya and Ethiopia.
"ארהב טוענת כי היא קיבלה מידע ממקור לא ידוע שמציין באופן ספציפי את השימוש במחבלים מתאבדים כדי לפוצץ אתרים בולטים באתיופיה וקניה."	The U.S. says it has received information from an undisclosed source that specifically mentions the use of suicide bombers to will blow up "prominent landmarks" in Ethiopia and Kenya.
ההכרזה של היום הרחיבה גם את התחייבות הממשלה ממרץ השנה לממן קרונות נוספים.	Today's announcement also extended the government's commitment made in March of this year to fund extra carriages.
תוספת של עוד 300 מביאה את הסך הכולל ל-1300 עגלות שצפויות להירכש כדי להקל על הצפיפות.	An additional 300 brings the total to 1,300 carriages to be acquired to relieve overcrowding.
מלווה בגורמים בכירים אלו, הוא הבטיח לתושבי טקסס שיינקטו צעדים לשמירה על ביטחון הציבור.	Accompanied by those officials, he assured Texas citizens that steps were being taken to protect the public's safety.
"פרי אמר במפורש: ישנם מקומות ספורים בעולם שמוכנים יותר לעמוד באתגר שניצב במקרה זה."	Perry specifically said, "There are few places in the world better equipped to meet the challenge that is posed in this case."
"המושל הוסיף ואמר, התגלה לנו היום שזוהו מספר ילדי בית ספר שבאו במגע עם החולה."	The governor also stated, "Today, we learned that some school aged children have been identified as having had contact with the patient."
"הוא המשיך ואמר, המקרה חמור. היו סמוכים ובטוחים שהמערכת שלנו עובדת כפי שהיא אמורה לעבוד"	He went on to say, "This case is serious. Rest assured that our system is working as well as it should."
"מאז עצמאות פקיסטן מהשלטון הבריטי ב- 1947, נשיא פקיסטן מינה סוכנים פוליטיים לשלוט ב- FATA (אזורים שבטיים המנוהלים באופן פדרלי), השולטים באזורים אלו באופן אוטונומי כמעט מוחלט."	Since Pakistani independence from British rule in 1947, the Pakistani President has appointed "Political Agents" to govern FATA, who exercise near-complete autonomous control over the areas.
סוכנים אלו אחראים לספק שירותי ממשל ומשפט על פי סעיף 247 של החוקה הפקיסטנית.	These agents are responsible for providing government and judicial services under Article 247 of the Pakistani Constitution.
ניגריה הכריזה קודם לכן כי היא מתכננת להצטרף ל- AfCFTA בשבוע לפני הפסגה.	Nigeria previously announced it planned to join the AfCFTA in the week leading up to the summit.
הממונה על המסחר והתעשייה באיחוד האפריקאי, אלברט מוצ'נגה, הודיע שבנין עתידה להצטרף.	AU trade and industry commissioner Albert Muchanga announced Benin was to join.
"המפקח אמר, עוד לא הסכמנו על חוקי מקור ועל הפחתת מכסים, אך המסגרת שיש לנו מספיקה כדי להתחיל לסחור בראשון ליולי, 2020."	The commissioner said, "We haven't yet agreed on rules of origin and tariff con[c]essions, but the framework we have is enough to start trading on July 1, 2020".
מושל מסצ'וסטס לשעבר מיט רומני זכה בבחירות הכלליות לנשיאות של המפלגה הרפובליקאית בפלורידה ביום שלישי עם מעל ל- 46% מהקולות.	Former Massachusetts governor Mitt Romney won the Florida Republican Party presidential primary election on Tuesday with over 46 percent of the vote.
"יושב ראש בית הנבחרים של ארהב לשעבר ניוט גינגריץ' הגיע למקום השני עם 32 אחוזים."	Former U.S. Speaker of the House Newt Gingrich came in second with 32 percent.
כמדינה בה המנצח לוקח הכל, פלורידה העניקה את כל חמישים הצירים שלה לרומני, ודחפה אותו קדימה כמועמד המוביל לנשיאות מטעם המפלגה הרפובליקאית.	As a winner-takes-all state, Florida awarded all fifty of its delegates to Romney, pushing him ahead as the front-runner for the Republican Party nomination.
מארגני המחאה אמרו כי בסביבות 100,000 איש הגיעו לערים בגרמניה כגון ברלין, קלן, המבורג והנובר.	Organisers of the protest said about 100,000 people turned up in German cities such as Berlin, Cologne, Hamburg, and Hanover.
בברלין, המשטרה העריכה שהיו 6,500 מפגינים.	In Berlin, police estimated 6,500 protestors.
מחאות נערכו גם בפריז, סופיה בבולגריה, וילנה בליטא, ולטה במלטה, טאלין באסטוניה, ואדינבורו וגלזגו בסקוטלנד.	Protests also took place in Paris, Sofia in Bulgaria, Vilnius in Lithuania, Valetta in Malta, Tallinn in Estonia, and Edinburgh and Glasgow in Scotland.
בלונדון, כ-200 בני אדם הפגינו מחוץ למשרדיהם של בעלי זכויות יוצרים מרכזיים.	In London, about 200 people protested outside some major copyright holders' offices.
בחודש שעבר, התקיימו מחאות רחבות היקף בפולין כאשר המדינה חתמה על הסכם הסחר נגד זיופים (ACTA), דבר שהוביל את ממשלת פולין להחליט שלא לאשר את ההסכם לעת עתה.	Last month, there were major protests in Poland when that country signed ACTA, which has led to the Polish government deciding not to ratify the agreement, for now.
גם לטביה וגם סלובקיה עיכבו את תהליך ההצטרפות ל-ACTA.	Latvia and Slovakia have both delayed the process of joining ACTA.
"בקשר למצב העולמי הפיננסי, זפאטרו המשיך ואמר ש המערכת הפיננסית היא חלק מהכלכלה, חלק חיוני שלה."	Regarding the global financial situation, Zapatero continued by saying that "the financial system is a part of the economy, a crucial part.
"יש לנו משבר פיננסי בן שנה, שהרגע האקוטי ביותר שלו היה בחודשיים האחרונים, ואני חושב שעכשיו השווקים הפיננסיים מתחילים להתאושש. "	We have a year-long financial crisis, which has had its most acute moment in the past two months, and I think now the financial markets are beginning to recover."
לאורך שנות 1960, ברזזינסקי עבד עבור ג'ון פ. קנדי כיועצו ולאחר מכן עבור ממשל לינדון ב. ג'ונסון.	Throughout 1960s, Brzezinski worked for John F. Kennedy as his advisor and then the Lyndon B. Johnson administration.
במהלך בחירות 1976 הוא ייעץ לקרטר במדיניות חוץ, לאחר מכן החליף את הנרי קיסינג'ר בשירותו כיועץ ביטחון לאומי (NSA) מ1977 עד 1981.	During the 1976 selections he advised Carter on foreign policy, then served as National Security Advisor (NSA) from 1977 to 1981, succeeding Henry Kissinger.
"בתור NSA הוא סייע לקרטר להתנהל בדיפלומטיות בענייני מדינות העולם (world affairs), כמו אירועי קמפ דייויד, 1978; נרמול יחסי ארהב-סין במהלך שנות ה-70 המאוחרות; המהפכה האיראנית, אשר הובילה למקרה בני הערובה, 1979; והפלישה הסובייטית לאפגניסטן, 1979."	As NSA, he assisted Carter in diplomatically handling world affairs, such as the Camp David Accords, 1978; normalizing US–China relations thought the late 1970s; the Iranian Revolution, which led to the Iran hostage crisis, 1979; and the Soviet invasion in Afghanistan, 1979.
"מאוחר ביום ראשון, נשיא ארהב דונלד טראמפ, הודיע שהכוחות האמריקאים יעזבו את סוריה, בהצהרה שהעבירה דוברת הבית הלבן."	Late on Sunday, the United States President Donald Trump, in a statement delivered via the press secretary, announced US troops would be leaving Syria.
ההצהרה נעשתה לאחר שטראמפ שוחח בטלפון עם הנשיא הטורקי רג'פ טאיפ ארדואן.	The announcement was made after Trump had a phone conversation with Turkish President Recep Tayyip Erdoğan.
טורקיה תקבל לידיה גם את השמירה על לוחמי דאעש השבויים שעל פי ההצהרה, מדינות אירופה סירבו להחזיר למולדתם.	Turkey would also take over guarding captured ISIS fighters which, the statement said, European nations have refused to repatriate.
מכונית תופת שהתפוצצה  במטה המשטרה בגזיינטפ, טורקיה, אתמול בבוקר הרגה שני שוטרים ופצעה יותר מעשרים אנשים נוספים.	A car bomb detonated at police headquarters in Gaziantep, Turkey yesterday morning killed two police officers and injured more than twenty other people.
משרד המושל דיווח כי 19 מתוך הפצועים היו שוטרים.	The governor's office said nineteen of the injured were police officers.
במשטרה אמרו, כי הם חושדים כי שלוחם דעאש לכאורה אחראי למתקפה.	Police said they suspect an alleged Daesh (ISIL) militant of responsibility for the attack.
דובל, נשוי עם שני ילדים מבוגרים, לא השאיר רושם משמעותי על מילר, אשר אליו היה קשור הסיפור.	Duvall, who is married with two adult children, did not leave a big impression on Miller, to whom the story was related.
"כשהתבקש להגיב, אמר מילר, מייק מדבר הרבה במהלך הדיון... אני התכוננתי, אז לא באמת שמעתי מה הוא אמר."	When asked for comment, Miller said, "Mike talks a lot during the hearing...I was getting ready so I wasn't really hearing what he was saying."
קבוצת המחקר העיראקית הציגה את הדוח שלה היום ב-12:00 לפי שעון גריניץ'.	The Iraq Study Group presented its report at 12.00 GMT today.
זה מזהיר שאף אחד לא יכול להבטיח שדרך פעולה כלשהי בעירק בנקודת זמן זו תעצור את הלוחמה בין הפלגים, עליה באלימות, או התדרדרות לכאוס.	It warns No one can guarantee that any course of action in Iraq at this point will stop sectarian warfare, growing violence, or a slide toward chaos.
"הדוח נפתח בבקשה לדיון גלוי ולהשגת קונצנזוס בארהב בנוגע למדיניות כלפי המזרח התיכון."	The Report opens with plea for open debate and the formation of a consensus in the United States about the policy towards the Middle East.
הדוח ביקורתי ביותר לגבי כמעט כל היבט במדיניות הנוכחית של הרשות המבצעת כלפי עיראק וקורא לשינוי כיוון מידי.	The Report is highly critical of almost every aspect of the present policy of the Executive towards Iraq and it urges an immediate change of direction.
הראשונה מבין 78 המלצותיה היא שיש לנקוט יוזמה דיפלומטית חדשה לפני סוף השנה כדי לשמור על גבולותיה של עיראק מפני התערבות עוינת ולכונן מחדש יחסים דיפלומטיים עם שכנותיה.	First among its 78 recommendations is that a new diplomatic initiative should be taken before the end of this year to secure Iraq’s borders against hostile interventions and to re-establish diplomatic relations with its neighbors.
סנטורית פעילה והגברת הראשונה של ארגנטינה, כריסטינה פרננדז דה קירשנר, הודיעה על מועמדותה לנשיאות אתמול בערב בלה פלטה, עיר הנמצאת כ־50 קילומטרים (31 מייל) מבואנוס איירס.	Current senator and Argentine First Lady Cristina Fernandez de Kirchner announced her presidential candidacy yesterday evening in La Plata, a city 50 kilometers (31 miles) away from Buenos Aires.
הגברת קירשנר הודיעה על כוונתה לרוץ לנשיאות בתאטרון הארגנטינאי, אותו מקום בו היא החלה את הקמפיין לסנאט ב־2005 כצירה של פרובינציית בואנוס איירס.	Mrs. Kirchner announced her intention to run for president at the Argentine Theatre, the same location she used to start her 2005 campaign for the Senate as member of the Buenos Aires province delegation.
"הוויכוח ניצת כתוצאה ממחלוקת סביב ההוצאות על רווחה ושיקום בעקבות ההוריקן קטרינה, שחלק מהשמרנים הפיסקלים כינו בהומור הניו אורלינס דיל של בוש."	The debate was sparked by controversy over spending on relief and reconstruction in the wake Hurricane Katrina; which some fiscal conservatives have humorously labeled "Bush's New Orleans Deal."
ביקורת ליברלית על מאמץ השיקום התמקדה בהענקת חוזי שיקום לגורמים הנחשבים מקורבים לוושינגטון.	Liberal criticism of the reconstruction effort has focused on the awarding of reconstruction contracts to perceived Washington insiders.
"נשיא ארהב, ג'ורג' וו. בוש, הגיע לסינגפור בבוקר ה-16 בנובמבר והחל ביקור בן שבוע באסיה."	U.S. President George W. Bush arrived in Singapore the morning of November 16, beginning a week-long tour of Asia.
את פניו קיבל סגן ראש הממשלה של סינגפור, וונג קן סנג, והוא דן בסוגיות של מסחר וטרור עם ראש ממשלת סינגפור לי הסיאן לונג.	He was greeted by Singapore's Deputy Prime Minister Wong Kan Seng and discussed trade and terrorism issues with the Singapore Prime Minister Lee Hsien Loong.
אחרי שבוע של הפסדים בבחירות אמצע הקדנציה, בוש סיפר לקהל על הרחבת הסחר באסיה.	After a week of losses in the midterm election, Bush told an audience about the expansion of trade in Asia.
"ראש הממשלה סטיבן הרפר הסכים לשלוח את חוק האוויר הנקי של הממשלה לוועדה כלל מפלגתית לבחינה, לפני הקריאה השנייה שלו, לאחר פגישה בת 25 דקות שנערכה ביום שלישי עם מנהיג ה-NDP ג'ק לייטון במשרד ראש הממשלה."	Prime Minister Stephen Harper has agreed to send the government's 'Clean Air Act' to an all-party committee for review, before its second reading, after Tuesday's 25 minute meeting with NDP leader Jack Layton at the PMO.
"במהלך פגישה עם ראש הממשלה, ביקש לייטון ביקש שייעשו שינויים בחוק להגנת הסביבה של השמרנים, ודרש שכתוב מלא ויסודי של החוק להגנת הסביבה של מפלגה השמרנית."	Layton had asked for changes to the conservatives' environmental bill during the meeting with the PM, asking for a "thorough and complete rewriting" of the Conservative party's environmental bill.
מאז שהממשל הפדרלי קיבל על עצמו את מימון בית החולים מרסי שבדבונפורט, טסמניה, ממשלת המדינה וכמה חברי פרלמנט פדרליים ביקרו מעשה זה בטענה שמדובר בתרגיל לקראת הבחירות הפדרליות שיתקיימו בנובמבר.	Ever since the Federal Government stepped in to take over funding of the Mersey hospital in Devonport, Tasmania, the state government and some federal MPs have criticised this act as a stunt in the prelude to the federal election to be called by November.
אך ראש הממשלה ג'ון האוורד אמר כי החוק נועד רק כדי להגן על מתקני בית החולים מפני שנמוך על ידי ממשלת טסמניה, באמצעות הענקת 45 מיליון דולר אוסטרלי נוספים.	But Prime Minister John Howard has said the act was only to safeguard the facilities of the hospital from being downgraded by the Tasmanian government, in giving an extra AUD$45 million.
נשיא ארצות הברית ג'ורג' וו בוש בירך על ההצהרה.	U.S. President George W. Bush welcomed the announcement.
"דוברו של בוש, גורדון ג'ונדרו, כינה את התחייבותה של צפון קוריאה צעד חשוב בדרך למטרה של השגת פירוק מנשק גרעיני, ניתן לאימות,  של חצי האי הקוריאני."	Bush spokesman Gordon Johndroe called North Korea's pledge "a major step towards the goal of achieving the verifiable denuclearization of the Korean peninsula."
התוצאות הסופיות של הבחירות לנשיאות ולפרלמנט של נמיביה מצביעות על כך שהנשיא המכהן, היפיקפוניה פוהאמבה, נבחר מחדש ברוב גדול.	Final results from Namibian presidential and parliamentary elections have indicated that the incumbent president, Hifikepunye Pohamba, has been reelected by a large margin.
מפלגת השלטון, ארגון האנשים של דרום מערב אפריקה (SWAPO), שמרה על רוב גם בבחירות לפרלמנט.	The ruling party, South West Africa People's Organisation (SWAPO), also retained a majority in the parliamentary elections.
חיילי הקואליציה וחיילים אפגנים עברו לאזור כדי לאבטח את האתר, וכלי טיס אחרים של הקואליציה נשלחו לסייע.	Coalition and Afghan troops moved into the area to secure the site and other coalition aircraft have been sent to assist.
ההתרסקות התרחשה גבוה בשטח הררי, ונראה שקרתה כתוצאה מירי עוין.	The crash occurred high up in mountainous terrain, and is believed to have been the result of hostile fire.
המאמצים לחיפוש אחר אתר ההתרסקות נתקלים במזג אוויר גרוע ותנאי קרקע קשים.	Efforts to search for the crash site are being met by bad weather and harsh terrain.
בצרפת, ההצבעה היא באופן מסורתי חוויה של טכנולוגיה פשוטה: המצביעים מתבודדים בתא ומכניסים למעטפה דף מודפס מראש המציין את המועמד בו הם בוחרים.	In France, voting has traditionally been a low-tech experience: voters isolate themselves in a booth, put a pre-printed sheet of paper indicating their candidate of choice into an envelope.
לאחר שהפקידים מאמתים את זהותו, הבוחר משלשל את המעטפה לקלפי וחותם בפנקס המצביעים.	After officials verify the voter's identity, the voter drops the envelope into the ballot box and signs the voting roll.
חוקי הבחירות בצרפת מסדירים באופן נוקשה למדי את ההליכים.	French electoral law rather strictly codifies the proceedings.
מאז 1988, קלפיות חייבות להיות שקופות כדי שהמצביעים והמשקיפים יהיו עדים לכך שלא היו מעטפות בקלפי לפני התחלת ההצבעה ושלא נוספות עוד מעטפות חוץ מאלה של המצביעים החוקיים והמורשים.	Since 1988, ballot boxes must be transparent so that voters and observers can witness that no envelopes are present at the start of the vote and that no envelopes are added except those of the duly counted and authorized voters.
המועמדים יכולים לשלוח נציגים שישמשו עדים בכל שלב בתהליך. בשעות הערב נספרים הקולות על ידי מתנדבים תחת פיקוח כבד, על פי נהלים ספציפיים.	Candidates can send representatives to witness every part of the process. In the evening, votes are counted by volunteers under heavy supervision, following specific procedures.
דובר בית הנבחרים לשעבר ניוט גינגריץ', מושל טקסס ריק פרי וחברת הקונגרס מישל בכמן סיימו במקום הרביעי, החמישי והשישי בהתאמה.	Former House Speaker Newt Gingrich, Texas governor Rick Perry, and Congresswoman Michele Bachmann finished in fourth, fifth, and sixth place, respectively.
לאחר שהגיעו התוצאות, גינגריץ' שיבח את סנטורום, אך אמר מילים קשות על רומני, שמטעמו שודרו באיווה פרסומי קמפיין שליליים נגד גינגריץ'.	After the results came in, Gingrich lauded Santorum, but had tough words for Romney, on whose behalf negative campaign advertisements were aired in Iowa against Gingrich.
"פרי הצהיר שהוא ישוב לטקסס כדי להעריך את תוצאות ועידת המפלגה שהתקיימה הלילה, כדי לקבוע אם יש מסלול קדימה עבורי במירוץ הזה, אך מאוחר יותר אמר שהוא יישאר במירוץ ויתמודד בבחירות בדרום קרוליינה ב-21 בינואר."	Perry stated that he would "return to Texas to assess the results of tonight's caucus, determine whether there is a path forward for myself in this race", but later said that he would remain in the race and compete in the January 21 South Carolina primary.
באכמאן, שניצחה בסקר הלא רשמי של איימז באוגוסט, החליטה לסיים את מסע הבחירות שלה.	Bachmann, who won the Ames Straw Poll in August, decided to end her campaign.
אני לא יודע אם אתם מבינים זאת או לא, אבל רוב הסחורה ממרכז אמריקה הגיעה למדינה זו עם פטור ממכס.	I don't know if you realize it or not, but most of the goods from Central America came into this country duty-free.
למרות זאת, 80% מהמוצרים שלנו חויבו במס לפי תעריפים של מדינות מרכז אמריקה. אנו דואגים לכם.	Yet eighty percent of our goods were taxed through tariffs in Central American countries. we treat you.
זה לא היה נראה לי הגיוני; זה בהחלט לא היה הוגן.	That didn't seem to make sense to me; it certainly wasn't fair.
כל מה שאני אומר לאנשים הוא התייחסו אלינו כמו שאנחנו מתייחסים אליכם.	All I say to people is you treat us the way we treat you.
מושל קליפורניה ארנולד שוורצנגר חתם על חוק האוסר מכירה או השכרה של משחקי וידאו אלימים לקטינים.	California Governor Arnold Schwarzenegger signed into law a bill that bans the sale or rental of violent video games to minors.
"הצעת החוק דורשת שמשחקי וידאו אלימים הנמכרים במדינת קליפורניה יסומנו במדבקה עם הכיתוב 18 והופכת את מכירתם לקטינים לעברה שדינה קנס של $1000."	The bill requires violent video games sold in the state of California to be labeled with a decal reading "18" and makes their sale to a minor punishable by a fine of $1000 per offense.
פרקליט המדינה קיר סטארמר מסר הבוקר הודעה על העמדתם לדין של הון ופרייס.	The Director of Public Prosecutions, Kier Starmer QC, gave a statement this morning announcing the prosecution of both Huhne and Pryce.
הונה התפטר ויוחלף בקבינט על ידי חבר הפרלמנט אד דייבי. חבר הפרלמנט נורמן לאם צפוי לקבל את משרת שר המסחר אותה יפנה דייבי.	Huhne has resigned and he will be replaced in the Cabinet by Ed Davey MP. Norman Lamb MP is expected to take the Business Minister job Davey is vacating.
הונה ופרייס צפויים להופיע בפני בית משפט השלום בווסטמינסטר ב-16 בפברואר.	Huhne and Pryce are scheduled to appear at the Westminster Magistrates Court on February 16.
המסמך, על פי ההדלפה, יתייחס לסכסוך הגבולות, שפלסטין רוצה שיתבסס על הגבולות שלפני מלחמת 1967 במזרח התיכון.	The document, according to the leak, will refer to the borders dispute, which Palestine wants based on the borders before the 1967 Mideast War.
על פי הדיווחים, נושאים אחרים שנדונו הם מעמדה העתידי של ירושלים, הקדושה לשני העמים, ושאלת בקעת הירדן.	Other topics covered reportedly include the future state of Jerusalem which is sacred to both nations and the Jordan Valley issue.
ישראל דורשת נוכחות צבאית קבועה בעמק הירדן במשך עשר שנים לאחר החתימה על הסכם בעוד הרשות הפלסטינית מסכימה להשאיר נוכחות כזאת חמש שנים בלבד.	Israel demands an ongoing military presence in the valley for ten years once an agreement is signed while the PA agrees to leave such presence only for five years.
מתוך 1,400 איש שהשיבו לסקר לפינ הבחירות הפדרליות ב-2010, מספר המתנגדים לכך שאוסטרליה תהפוך לרפובליקה עלה ב-8 אחוזים מאז 2008.	Out of 1,400 people polled prior to the 2010 federal election, those who oppose Australia becoming a republic grew by 8 per cent since 2008.
ראש הממשלה המטפלת, ג'וליה גילארד, טענה במהלך קמפיין הבחירות הפדרליות בשנת 2010 כי היא מאמינה שאוסטרליה צריכה להפוך לרפובליקה בסוף שלטונה של המלכה אליזבת השנייה.	Caretaker Prime Minister Julia Gillard claimed during the campaign of the 2010 federal election that she believed Australia should become a republic at the end of Queen Elizabeth II's reign.
34% ממשתתפי הסקר חולקים בהשקפה זו, ומעוניינים שהמלכה אליזבת השנייה תהיה המלכה האחרונה של אוסטרליה.	34 per cent of those in the poll share this view, wanting Queen Elizabeth II to be Australia's last monarch.
בקצוות הסקר, 29% מהמשתתפים מאמינים שאוסטרליה צריכה להפוך לרפובליקה בהקדם האפשרי, בעוד 31% מאמינים שהיא לעולם לא צריכה להפוך לרפובליקה.	At the extremes of the poll, 29 per cent of those surveyed believe Australia should become a republic as soon as possible, while 31 per cent believe Australia should never become a republic.
קואומו, 53, החל את תפקידו כמושל מוקדם יותר השנה וחתם בחודש שעבר על הצעת חוק המאשרת נישואים חד-מיניים.	Cuomo, 53, began his governorship earlier this year and signed a bill last month legalizing same-sex marriage.
"הוא התייחס לשמועות כפטפטת ושטויות פוליטיות."	He referred to the rumors as "political chatter and silliness".
משערים שהוא יתמודד על הנשיאות ב-2016.	He is speculated to make a run for president in 2016.
