Ce sont des esprits qui ont fait le coup.	I will tell you...
"Attendez!"	"Wait!"
"Attendez!"	"Wait!"
Nuit...	Night...
Nuit...	Night...
Cesare !	Cesare!
"Décrivez-le-moi."	Describe it.
Hey!	Hey!
Du poison.	Poison.
Quand on prie la bonne étoile	When you wish upon a star
La fée bleue secoue son voile	Makes no difference who you are
Quand on prie de tout son cœur	If your heart is in your dream
Il n'y a pas de faveur	No request is too extreme
Quand on prie la bonne étoile	When you wish upon a star
Ames tendres	As dreamers do
Cœurs tristes et cœurs aimants	Fate is kind
Le destin bienfaisant	She brings to those who love
Essayez	Their secret longing
Faites un vœu	Like a bolt out of the blue
Joli, hein ?	Pretty, huh?
Avant, moi non plus.	Well, I didn't either.
C'était une nuit magnifique.	It was a beautiful night.
Belle comme une image.	Pretty as a picture.
C'était dommage de voir gaspiller un si beau feu.	It was a shame to see a nice cheerful fire like that going to waste.
Alors que fis-je ?	So what do I do?
Je vais y aller.	I go in.
Je regardai.	I looked around.
Quand je vis qu'il n'y avait personne, je fis comme chez moi.	Soon as I saw there was no one about, I made myself at home.
Je n'avais jamais vu un endroit pareil.	Well, sir, you never saw such a place.
Un pantin !	A puppet!
Vous savez, ces marionnettes faites de bois et de ficelle.	You know, one of those marionette things, all strings and joints.
Mignon petit gars.	Cute little fella.
C'est du beau bois.	Good piece of wood too.
Voilà.	Well, now.
Nous sommes bientôt arrivés.	It won't take much longer.
Un petit peu de peinture et il sera terminé.	Just a little more paint and he's all finished.
Très bien.	Very good.
On ne peut pas plaire à tout le monde.	Well, you can't please everybody.
Pinocchio !	Pinocchio!
Ça te plaît, Figaro ?	Do you like it, Figaro?
Non?	No?
Et toi, Cleo ?	You do, don't you, Cleo?
- Cela te plaît?	Do you like it?
C'est réglé.	That settles it!
Ça sera Pinocchio !	Pinocchio it is!
Viens, on va t'essayer.	Come on, now, we'll try you out.
Musique, professeur !	Music, Professor!
Petits pieds en bois sans oublier	Little wooden feet and best of all
Petit siège en bois pour ne pas tomber	Little wooden seat in case you fall
Quelle grâce !	How graceful!
Cleo, voici Pinocchio.	Cleo, meet Pinocchio.
Dis : "Enchanté."	Say, "How do you do?"
Dis bonjour à Figaro.	Say hello to Figaro.
Tu vois ce qui arrive ?	You see what happens?
On remonte !	Up we go!
Tu sais, Pinocchio, je crois que Figaro estjaloux.	You know, Pinocchio, I think Figaro is jealous of you.
Je me demande l'heure qu'il est.	I wonder what time it is.
Il se fait tard.	It's getting late.
Bonne nuit, Pinocchio.	Good night, Pinocchio.
Figaro.	Figaro.
J'ai essayé, il n'y a rien à faire.	Go on.
Ça, c'est le confort.	This is my idea of comfort.
Un confort solide.	Solid comfort.
N'aimerais-tu pas qu'il soit un vrai garçon ?	Wouldn't it be nice if he was a real boy?
Un vrai garçon !	A real boy!
Qu'est-ce que c'est que ça ?	Quiet!
Il ne faut pas exagérer.	After all, enough's enough.
Pourquoi ?	Now what's up?
Que se passe-t-il ?	Hey, what's going on here?
Bonté divine, une fée !	As I live and breathe, a fairy!
Petit pantin de bois, réveille-toi.	Little puppet made of pine, wake.
Je t'offre la vie.	The gift of life is thine.
Je bouge !	I can move!
Je parle !	I can talk!
Je marche !	I can walk!
C'était inhabituel ?	- Why?
- Suis-je un vrai garçon ?	- Am I a real boy?
-Ce ne sera pas facile.	That won't be easy.
Tu te souviens, le péché?	Right and wrong?
Mais comment savoir ?	But how will I know?
- Ta conscience te guidera.	- Your conscience will tell you.
- C'est quoi, la conscience ?	- What are conscience?
- La conscience ?	- What are conscience!
Je vais vous le dire !	I'll tell ya!
- Es-tu ma conscience ?	- Are you my conscience?
Moi ?	Who, me?
Pas de blague.	No tricks now.
Levez-vous, Messire Jiminy Cricket.	Arise, Sir Jiminy Cricket.
Dites, c'est extra.	Say, that's pretty swell.
Super, merci.	Gee... thanks.
- On verra.	- Well, we'll see.
- Ça ne m'étonnerait pas.	- I shouldn't wonder.
- En or ? - Peut-être.	- Make it a gold one?
Peut-être.	Maybe.
Bon.	All right.
Assieds-toi.	Sit down, son.
- Compris ?	- Understand?
Comme ça?	Like this?
Comme ça?	Like this?
Non, petit.	No, son.
Maintenant, écoute.	Now, listen.
Lorsque vous craignez soudain De faire fausse route	When you get in trouble and you don't know right from wrong
Sifflez, vite, vite	Give a little whistle
Sifflez, vite, vite	Give a little whistle
Quand le mal l'emporte Et que le cœur est en déroute	When you meet temptation and the urge is very strong
Sifflez, vite, vite	Give a little whistle
Sifflez, vite, vite	Give a little whistle
Mais dans le cas Où ça ne suffirait pas	Not just a little squeak Pucker up and blow
Sifflez, vite, vite	Give a little whistle
Sifflez, vite, vite	Give a little whistle
Alors votre conscience paraîtra	And always let your conscience be your guide
Alors votre conscience paraîtra	And always let your conscience be your guide
- Qui est-ce ?	- Who is there?
Ah, c'est lui.	Oh, it's me.
Quelqu'un est là.	There's somebody in here.
Il doit être par ici.	He's in here somewhere.
Me voici !	Here I am!
Pinocchio !	Pinocchio.
Comment es-tu arrivé là ?	How did you get down here?
- Je suis tombée.	- I fell down.
Vous avez fait ça?	- Oh, you did.
Vous parlez !	You're talking!
Mince, tu es marrant.	Gee, you're funny.
- Recommencez.	Do it again!
- Une conscience !	- A conscience!
- Très.	Yeah, cute.
Ça se fête.	This calls for a celebration.
-Musique.	Music!
A toi, Pinocchio.	You start one, Pinocchio.
Bon sang.	Oh, boy.
Vous permettez ?	Mind if I cut in?
Oh, joli.	Ooh, nice.
- Voyez !	- Look!
À l'aide !	Help!
Quelle nuit, mes amis.	Little man, you've had a busy night.
Ferme les yeux et endors-toi.	Now, close your eyes and go to sleep.
- L'extraire ?	Why?
- L'extraire ?	Why?
- L'extraire ?	Why?
- Parce que.	- Because.
Ne bouge pas.	Stand still now.
- Qu'est-ce que c'est ?	- What are those?
C'est mon père.	- Yes.
Mais dépêche-toi.	But hurry now.
Va jouer, maintenant.	Run along now.
L'école, ce n'est pas pour toi.	School is not for you.
De petits esprits assoiffés courant vers la fontaine du savoir.	Thirsty little minds rushing to the fountain of knowledge.
L'école, quelle noble institution.	School, a noble institution.
Quelqu'un doit pouvoir m'en offrir une fortune.	A thing like that ought to be worth a fortune to someone.
Voyons voir.	Now let me see.
"C'est ça !"	That's it!
- Écoute !	- Listen.
Non, non, imbécile.	No, no, stupid.
Ne soyez pas vulgaire.	Don't be crude.
Je m'en occupe.	Let me handle this.
Il arrive.	Here he comes.
Je suis terriblement désolé.	Oh, I'm terribly sorry.
- Je vais bien.	- I'm all right.
- Oh, magnifique.	- Oh, splendid.
Regarde, Gédéon, un homme de lettres.	Look, Giddy, a man of letters.
- Voici ton livre.	- Here's your book.
- Je vais à l'école.	- I'm going to school.
L'école...	School.
Ah oui !	Ah, yes.
- Non ?	- No?
- La célébrité ?	- Fame?
- Quel est votre nom?	- What is your name?
Aïe dirlididi A moi la vie d'artiste	Hi diddle dee dee An actor's life for me
Aïe dirlidida La vie est un gala	Hi diddle dee day An actor's life is gay
- Quoi donc?	- What was that?
Où ça ?	Up where?
Il n'y a rien d'inquiétant sur ce chapeau.	Why, there's nothing up there to be afraid of.
Par ici.	Over here.
- Eh bien, c'est lui.	- Well, that's him.
Grand Coquin ?	Honest John?
Vous voilà !	Ah, there you are!
Où en étlons-nous ?	Now, where were we?
Mesdames et messieurs, pour conclure ce grand spectacle,	Ladies and gentlemen, to conclude the performance of this great show,
- Je l'espère.	I hope so.
Le seul et unique... Pinocchio !	The one and only Pinocchio!
Mignonne, la petite.	Cute kid.
Et vive les heureux jours Gâcher sa vie, c'est trop bête	I want the world to know Nothing ever worries me
Qui tire les ficelles	There are no strings on me
Qu'est-ce qu'un acteur ferait d'une conscience ?	What does an actor want with a conscience anyway?
Qu'a-t-il bien pu lui arriver ?	What could have happened to him?
Où peut-il être à cette heure ?	Where could he be at this hour?
Je retourne le chercher.	I'd better go out again and look for him.
- Bravo, Pinocchio !	- Bravo, Pinocchio!
- Ils m'adoptent.	- They like me.
Tu es énorme !	You are colossal!
Ton visage sera sur toutes les langues.	Your face, she will be on everybody's tongue.
- Vraiment?	- Will she?
- Tu pars ?	What's this?
Pour toi, mon petit Pinocchio.	For you, my little Pinocchio.
- Pour moi ?	For me?
Merci.	Gee, thanks!
Je cours chez moi montrer ça à mon père.	I'll run right home and tell my father.
- Chez toi ?	Home?
- Je reviens demain matin.	- I'll be back in the morning.
chez vous...	Going home.
"Monte-Carlo."	Monte Carlo.
Non, non !	- No, no!
Non !	- Yes!
Tu gagneras plein d'argent... pour moi !	You will make lots of money... for me!
Qu'est-ce que c'est que ça ?	Quiet!
Non, attendez!	No! No, wait!
Allez.	Get along there.
Je vais discrètement sortir de sa vie.	I'll just go out of his life quietly.
Oui, oui... pourquoi pas ?	Sure! Why not?
Que s'est-il passé ?	What's happened?
Tu crois ça ?	Oh, is that so?
C'est ce que j'ai dit !	That's what I said.
Ça doit être un vieux modèle.	Must be one of the old models.
Alors, tu ne peux pas l'ouvrir ?	You mean, you can't open it?
Moi et toi...	Yeah.
Je ne reverrai jamais mon père.	Guess I'll never see my father again.
Souffle.	Come on, blow.
Bien.	Thatta boy.
Encore cette étoile !	Hey, that star again!
- Que vais-je lui dire ?	- What'll I tell her?
- Dis-lui la vérité.	- You might tell her the truth.
Pinocchio, pourquoi n'es-tu pas allé à l'école ?	Pinocchio, why didn't you go to school?
-Une école?	- School?
Dites-le-lui.	- Go ahead, tell her.
J'allais à l'école etj'ai rencontré quelqu'un.	I was going to school 'til I met somebody.
- Rencontré quelqu'un ?	- Met somebody?
Vous n'aviez pas peur?	- Weren't you afraid?
- Non !	- No!
- Oui.	- Yeah!
- Tu t'es enfui ?	- How did you escape?
- Non, j'ai...	- I didn't.
Que s'est-il passé ?	What's happened?
Aïe dirlididi A moi la vie d'artiste	Hi diddle dee dee An actor's life for me
Aïe dirlidida La vie est un gala	Hi diddle dee day An actor's life is gay
Vous voyez...	You see--
- Les garçons stupides ?	- Stupid little boys?
- Non, merci.	- No, sir.
Heureusement.	- You'd better.
Ça, c'est parlé !	Now you're talkin'!
- Bonjour.	Oh, hello.
- Vraiment ?	- He did?
Mon Dieu !	Bless my soul.
Je l'avais vu, moi.	- I knew it!
- Rien.	- Nothing.
- Allergique ?	- Allergic?
- L'île enchantée ?	- Pleasure Island?
Je te donne mon billet.	I'm giving you my ticket.
- Tiens...	- Here.
Aïe dirlididi A moi l'île enchantée	Hi diddle dee dee It's Pleasure Isle for me
Eh bien, c'est reparti !	Well, here we go again.
Et vous ?	What's yours?
Pinocchio !	Pinocchio.
Prenez du gâteau, de la tarte ou de la glace.	Get your cake, pie, dill pickles and ice cream.
C'était inhabituel ?	- Why?
Maintenant, descendez et préparez les caisses.	Now get below and get them crates ready.
Donnez ce qu'il veut à un mauvais garçon et il deviendra vite un âne.	Give a bad boy enough rope and he'll soon make a jackass of himself.
Non mais !	Where is everybody?
Pinocchio !	Pinocchio!
Eh, où êtes-vous ?	Hey, where are you?
Amen !	Yeah!
Pour sûr.	It sure is!
On s'amuse bien, hein ?	Some fun, huh, kid?
Pinocchio !	Pinocchio!
Comment veux-tu devenir un vrai garçon ?	How do you ever expect to be a real boy?
Regardez-vous.	Look at yourself.
Ow!	Ow!
Reposez-moi !	Put me down!
Quoi ?	What?
Une sauterelle ?	Grasshopper?
- Votre meilleur ami ?	- Your best friend?
Me voilà fixé. C'est nul.	Okay, that settles it.
D'où viennent tous ces ânes ?	Where'd all the donkeys come from?
Et comment vous appelez-vous ?	And what's your name?
Rentre là-dedans !	In you go!
Je vais en tirer un bon prix. VENDU AU CIRQUE VENDU AUX MINES DE SEL	You boys'll bring a nice price.
Bon, au suivant !	All right, next!
- Alexandre.	- Alexander.
- Silence !	- Quiet!
"Garçons" ?	"Boys"?
♪ Ha !	Ha!
La conscience.	Conscience.
Et comment!	You sure do!
Hé, tu ris comme un âne.	Hey, you laugh like a donkey.
C'est sorti de moi?	Did that come out of me?
Maman!	Mama!
- Pourvu que j'arrive à temps.	- I hope I'm not too late.
Qu'est-ce que je vais dire ?	What'll I do?
- Oh, toi aussi !	Oh, you too!
Tu dois sauter !	You gotta jump!
Bien sûr.	Sure.
Je ne pensais pas qu'on y arriverait.	I thought we'd never make it.
Viens, rentrons à la maison.	Come on, let's get home.
Peut-être qu'il dort.	Hey, maybe he's asleep.
Pinoke, viens voir.	Pinoke, come here.
Regarde-moi ça.	Look.
Il est pas là.	He ain't here.
Ne t'inquiète pas, petit, il ne doit pas être loin.	Don't worry, son, he probably hasn't gone far.
- C'est un message.	- It's a message.
- Qu'est-ce qu'il dit ?	- What's it say?
- C'est à propos de ton père.	- It's about your father.
- Où est-il ?	- Where is he?
Où tu vas ?	Where you going?
Je vais le retrouver.	I'm going to find him.
Je ne serai peut-être qu'un appât mais je viens avec toi.	I may be live bait down there, but I'm with ya.
Allons-y.	Come on, let's go.
Attention en bas !	Look out below!
Poussez-vous, là en bas.	Gangway, down there.
Au revoir.	Well, so long.
Papa !	Father!
Hé, Pinoke, attends-moi !	Hey, Pinoke, wait for me!
Papa !	Father!
Papa !	Father!
Hé !	Hey, what the--
Ça les a effrayés.	That got 'em.
Papa !	Father!
- Bonjour.	Oh, hello.
Poussez-vous.	Break it up now.
Hé !	Hey, what the--
L'un de vous peut-il me dire où je peux trouver Monstro ?	Could any of you tell me where to find Monstro?
Aucune prise depuis des jours.	Not a bite for days.
On ne tiendra plus très longtemps.	We can't hold out much longer.
C'était un si brave garçon.	He was such a good boy.
C'est sans espoir, Figaro.	It's hopeless, Figaro.
Il n'y a plus de poisson.	There isn't a fish left.
Il y en a plein ici.	Here they come!
Qu'ils restent là, Figaro !	Keep them in there, Figaro!
Hey!	Hey!
Faut qu'on sorte d'ici !	We got to get out of here!
Je n'en ai jamais vu autant !	Never saw so many!
Et y en a un autre!	Here's another one!
Il y en a pour des semaines !	Enough for weeks!
En voilà un gros.	Here's a big one.
Qu'ils restent là, Figaro !	Keep them in there, Figaro!
- En voici un autre.	- Here's another one.
Papa !	Hey, Father!
- Père !	- Father!
- Père !	- Father!
Donne-moi ton chapeau.	Let me take your hat.
Pinocchio !	Pinocchio!
- Ces oreilles !	- Those ears!
-Hein ?	- Huh?
- Que t'est-il arrivé ?	What's happened to you?
Arrête-toi !	Hey! Cut it out!
- Un radeau?	- A raft?
Non, non.	No, no, no, no.
- Je n'en aurai pas besoin.	We won't need it.
Eh bien, c'est pas trop tôt !	Well, it's about time!
- Ça ne marchera pas!	- It won't work!
Attendez !	Hang on!
Santé.	Gesundheit.
- On repart dans l'autre sens !	- We're going back!
On a réussi !	We made it!
Je te l'avais bien dit !	I told you he'd be furious!
Il est parti !	- He's gone!
Où est-il ?	- Where did he go?
Attention!	Look out!
Attendez !	Hang on!
Elle revient.	He's coming back.
Marche arrière !	Let's go back!
Attention!	Look out!
Sautez!	Jump!
Père?	Father! Father!
James, mon garçon...	My boy.
Prouve ta bravoure, ta générosité et ta sincérité et un jour, tu deviendras un vrai garçon.	Prove yourself brave, truthful and unselfish, and someday you will be a real boy.
Papa !	Father!
Non.	No, I'm not.
Si, vous l'êtes.	Yes, yes, you are.
Bien, allongez vous.	Now, lie down.
- Moi, je suis réel.	- I'm real.
Je suis un vrai garçon !	I'm a real boy!
Tu es vivant !	You're alive!
Il faut fêter ça.	This calls for a celebration!
Professeur, musique !	Professor, lots of music!
Merci, milady.	Thank you, milady.
Il méritait d'être un vrai garçon.	He deserved to be a real boy.
Eh ben, mon bonhomme...	- Well, I'll be!
Mon Dieu !	My, my!
Réveille-toi.	Wake up.
Quoi ! qu'est-ce qu'il y a encore !	- What now?
Qu'est-ce qui se passe ?	What's going on around here?
- Réveillez-vous.	- Wake up.
- C'est déjà arrivé.	- It's happened.
Viens...	- Come on.
Allons, dépêche-toi, ou tu vas rater le bateau.	You better hurry up.
- Je vais te montrer.	Well, look.
- Bien.	- Well.
– Il est pas mignon ?	- Isn't he cute?
Vous méritez des félicitations.	You're to be congratulated.
- Oui, félicitations.	- Yes, congratulations.
- Félicitations.	- Congratulations.
Merci beaucoup.	Thank you very much.
Regarde-moi ça.	Look.
Il tente de se relever.	He's trying to get up.
Panpan.	Thumper.
Il l'est vraiment.	Well, he is.
Tu crois que ça intéresse Monsieur ?	Aren't you?
- Allez.	Come on.
Panpan.	Thumper.
- Bonjour.	- Good morning.
Au revoir.	Goodbye.
Bonjour.	Good morning.
- Qu'est-ce qu'il y a ?	- What's the matter?
- Qu'est-ce qui ne va pas ?	- What happened?
- Il est blessé ?	- Is he hurt?
Panpan.	Thumper.
Allez, lève-toi.	Come on, get up. Get up.
- Je peux pas.	- Get up.
Essayez à nouveau.	- Try again.
Minus !	Thumper!
- Allez.	Come on.
Tu y arriveras.	You can do it.
Ils font comme ça.	Like this.
Oiseau.	Bird.
Oiseau.	Bird.
Oiseau.	Bird.
Il a parlé.	He talked.
Oiseau.	Bird.
Un papillon ?	Butterfly?
Bouton...	Butter...
Papillon.	Butterfly.
- C'est joli.	- It's pretty.
C'est joli.	Pretty.
Fleur.	Flower.
Moi ?	Me?
- C'est un petit...	- He's a little...
- Merci.	- That's all right.
Cela ne me dérange pas.	I don't mind.
C'est joli.	Pretty.
Bon sang !	Gosh.
La prairie ?	Meadow?
Où as-tu entendu ça?	- Where did you hear that?
C'est vrai, il a raison.	Well, he's right.
Son attitude n'était pas suspecte ?	Perhaps.
Chut, maintenant.	Hush now.
On y est presque.	We're almost there.
Attendez.	- Wait.
Pete.	Wait here.
D'accord.	It's all right.
- Allez.	Come on.
- Salut. - Salut.	Hello.
Il est délicieux.	It's delicious.
C'est ça qui est bon.	That's the good stuff.
Panpan.	Thumper.
- De quoi s'agit-il?	- Yes, Mama?
- Que t'a dit ton père ?	- What did your father tell you?
À propos de quoi ?	About what?
Ah, celui-là !	Oh, that one.
Bonjour, Bambi.	Hello, Bambi.
On s'est dit bonjour.	I said hello.
Pas vrai, que tu n'as pas peur ?	You're not afraid, are you?
Allez-y, dites bonjour.	Go on, say hello.
- Salut. - Salut.	Hello.
De toi.	You.
Oui je sais.	Yes, I know.
Bambi !	Bambi.
- Mère.	Mother.
Bambi !	Bambi.
- Mère.	Mother.
- Allez.	Come on.
Il n'y a plus de danger.	It's safe now.
Maman, regarde.	Mother, look.
- De la neige ?	- Snow?
C'est mon père.	- Yes.
- Allez.	Come on.
D'accord.	It's all right.
Regarde-moi ça.	Look.
Reléve-toi donc.	Come on, get up.
Ils font comme ça.	Like this.
Réveille-toi.	Wake up.
Pourquoi tu veux faire ça ?	What do you want to do that for?
Eh bien, bonne nuit.	Well, good night.
Mais ça ne durera pas pour toujours.	But it won't last forever.
Oui je sais.	Yes, I know.
Regarde-moi ça.	Look.
Bambi !	Bambi.
Vite.	Quick.
Allez-y!	Faster.
Plus vite, Bambi.	Faster, Bambi.
Ne te retourne pas.	Don't look back.
Cours.	Keep running.
Cours.	Keep running.
On y est arrivés.	We made it.
Nous...	We...
- Mère.	Mother.
Maman, où es-tu ?	Mother, where are you?
Ta mère ne peut plus être avec toi.	Your mother can't be with you anymore.
- VENEZ...	Come.
Mon fils...	My son.
Qu'est-ce que tu...	Wait.
Et maintenant?	What now?
Hé.	Hey.
allez!	Scat.
Voilà.	There.
Oh, â quoi bon ?	Oh, what's the use?
Arrêtez !	Stop it.
Hey !	Get out of here.
Tout ce que vous en êtes.	All of you.
- Et vous aussi,	And you, too.
Bambi.	Bambi!
Bonjour, Bambi.	Hello, Bambi.
- Tu te souviens de moi?	Remember me?
Panpan.	Thumper.
Oui.	Right.
- Salut, les gars.	Hi, fellas.
Fleur.	Flower.
Moi et toi...	Yeah.
Et après, vous savez quoi ?	And then you know what?
- Horrible.	- Terrible.
Personne n'est à l'abri.	It can happen to anybody.
Moi non plus.	- Me neither.
Moi non plus.	- Me neither.
Il a perdu la boule.	Twitterpated.
Bonjour, Bambi.	Hello, Bambi.
Tu ne te souviens pas de moi ?	Don't you remember me?
Bambi !	Bambi.
Attends que je regarde.	And you
Dépêchez-vous.	Hurry.
Suivez-moi.	Follow me.
Écoute.	Listen.
Le voilà.	- He's coming.
- Tais-toi !	- Hush.
Silence.	Be quiet.
- Mais je suis une pauvre veuve.	- Be calm.
Ne t'énerve pas.	Don't get excited.
- Non.	- No.
Il vous expliquera.	He's almost here.
Ça m'est insupportable.	I can't stand it any longer.
Bambi !	Bambi.
Debout.	Get up.
Il faut que tu te relèves.	You must get up.
Debout.	Get up.
Debout.	Get up.
Suis-moi.	Now, come with me.
Bambi !	Bambi.
Réveille-toi.	Wake up.
Et maintenant?	What now?
- C'est déjà arrivé.	- It's happened.
- Quoi donc ?	- Happened?
Très bien.	Oh. Well.
Regarde-moi ça.	Look.
Deux divorces.	Two of them.
Un vieil ami à moi.	An old friend of mine.
- Je ne savais pas.	- Oh, I didn't know.
Merci.	- Thank you.
- Oui ?	- Yes?
Ethel.	Ethel.
Ça me met mal à l'aise.	Makes me nervous.
Tiens !	Here!
- Je ne sais pas.	I don't know.
Que s'est-il passé ensuite ?	Then what happened?
Qu'est-ce qui se passe ?	What's going on here?
C'était un disque.	It's on the record.
- Je l'ai fait.	- I did, sir.
C'était inhabituel ?	- Why?
Je...	I ...
Je ne voulais pas venir ! Je veux m'en aller !	I told you we shouldn't have come here!
- Ta gueule !	- Shut up!
Quel genre d'homme est-ce ?	What kind of a man is he?
Qui le connaît ?	Who knows him?
- Je te l'avais dit !	- I told you!
Oui, maréchal.	Yes, sir.
C'est bizarre.	Very peculiar.
- On m'a recrutée.	- I was hired.
- Par qui?	- By whom?
- Tu l'as vu ?	- You saw him?
- Non.	- No.
Inconnu)	Unknown
Je ne le suis pas.	That's a lie!
Maintenant, je me souviens.	Now I remember.
- Qu'est-ce qui ne va pas ?	- What happened?
Tout à fait, monsieur.	I quite agree, sir.
- Non, merci.	- No, sir.
Ah, tu en as un peu plus.	It's wonderful!
C'est vrai, mon général.	Really!
-Hein ?	- Huh?
Il y a que j'en ai assez.	What did you say?
- Il ne bouge plus.	- He's not moving.
- Qu'a dit le docteur ?	- What did the doctor say?
- Mort.	- Dead.
Quoi ?	What?
Défense de toucher !	Don't touch!
Sens un peu.	Smell it.
- Un suicide ?	- Suicide?
Docteur!	Doctor!
Bonjour, général.	Good morning, General.
Bonjour.	Good morning.
- Quoi ?	- What?
Je ne comprends pas.	- I don't understand it.
- Huit.	- Eight.
Il faut que je mange, non ?	What about breakfast?
- Quoi ?	- What?
- Quoi ?	- What?
- Sa femme.	- His wife.
Hein?	- Eh?
Ma femme ?	- Wife?
Je n'y crois pas !	I don't believe it!
Prends ton temps !	Take your time!
- Quoi ?	- Got what?
- Moi aussi.	- Me too.
Tout de suite.	Immediately.
Entendez-vous ?	Do you hear that?
Nous aussi.	So are we.
- Sire John !	Sir John!
- Personne !	- Nobody!
Je ne la comprends pas.	I don't understand it.
C'est ça.	That's right.
- Oui. - Je sais où il est.	- I know where he is.
Qu'est-ce que c'est ?	What is it, man?
- Je m'y attendais.	- I was expecting that.
J'ai très bien compris.	Perfectly clear.
Est-ce bien nécessaire?	Do you have to do that?
- Qui?	- Who?
- Quoi donc ?	Which one?
- On n'en a pas besoin.	- We don't.
- C'est ce que je pensais.	- That's what I was thinking.
- Nous ne savons rien de lui.	- What do we know about him?
C'est un fait.	That's a fact.
Je ne vois pas pourquoi.	I don't see why.
Merci.	Thank you.
Et qui vous suspectez ?	Whom do you suspect?
Vous n'avez pas le droit !	You can't do that!
Le temps nous le dira.	Time will tell.
Et alors ?	What about it?
Non, merci.	No, thank you.
- Allez, entre.	The more the merrier.
- Oui?	- Yes, sir?
Merci.	Thank you.
- Tu le lui as dit ?	- Have you told him?
- Oui.	- Yes, sir.
- Non, attends!	No wait!
Ouvrez!	Open up!
Ouvre!	Open the door!
- Je rentre a la maison.	- What for?
Dépêchez-vous.	Hurry up!
Il pleut.	It's raining!
N'ayez crainte, Monsieur.	Don't worry about me, sir.
Laisse tomber.	Never mind.
- Bonne nuit.	- Good night.
- Bonne nuit.	- Good night.
- Bonne nuit.	- Good night.
- Bonsoir, chef.	- Good night, sir.
Elle n'est pas là !	She's not here!
Quel mal y a-t-il ?	What's wrong with that?
Regarde-moi ça.	Look.
Qu'est-ce que c'est ?	- What's that?
- Où est-il ?	- Where is he?
Rogers ! Rogers !	Rogers!
Rogers ! Rogers !	Rogers!
Il n'est pas là.	- He's not there.
Il était ivre.	He got drunk.
Il est mort.	He's dead.
- Non.	- No.
- Quoi ?	- What?
- 1, 2, 3.	- One. Two. Three.
Oui ! J'attendrai !	I get it!
Non, je ne l'aime pas.	No I don't.
Non, pourquoi ?	No, why?
Que lui est-il arrivé ?	What happened to the boy?
Je sais!	I got it!
- Qui?	- Who?
- Rogers !	- Rogers.
D'accord.	Fact.
Il faut de l'entraînement.	It takes practice.
Bien sûr.	Of course.
Lombard !	Lombard!
- Que faites-vous là ?	- What you doing here?
- Laquelle?	- Why is that?
- Pas même une femme ?	How about a woman?
C'est elle !	It's her!
Qu'en sait-on?	How do we know?
On m'a rien demandé.	Nobody asked me.
Je le tiens. Viens vite, je le tiens.	I've got him!
Je sais où il est.	I know where it is.
- L'argent n'est pas ici !	- It's not here!
- Espèce de...	- Don't.
Elle n'est pas là.	It's not here.
- Qu'en as-tu fait ?	- What did you do with it?
- Qu'en as-tu fait ?	- What did you do with it?
Et vous ?	What about yourself?
Et pourquoi pas ?	Why not?
Je le ferai.	I shall.
- Je ne sais pas.	I don't know.
- Véra ?	- Vera?
- Ne t'approche pas !	- Don't come any closer!
- Où est-elle ?	- Where is she?
Je ne dirai rien.	I won't say a word.
N'avancez pas plus près !	Don't come any closer!
Ne t'inquiète pas pour moi.	- Don't worry about me.
-Ne discute pas.	- Come on!
Laisse-moi tranquille !	Don't bother me.
Oui ! J'attendrai !	I get it!
- Restez où vous êtes!	- Stay where you are!
Pourquoi?	- Why not?
- Qui?	- Who?
Fort bien !	I see!
- Maintenant ?	- Now?
C'est tout.	That's all.
Merci.	- Thank you.
- Vera !	-Vera!
- Qui donc ?	-Who is it?
Où étais-tu ?	- Where have you been?
- Votre chambre ?	Your room?
-Que t'est-il arrivé?	- What happened to you?
Avez-vous entendu quelque chose ?	- Did you hear anything?
Vera !	Vera!
Vera !	Vera!
Qu'est-ce qu'il s'est passé ?	What happened?
- Qui?	- Who?
- Qui?	- Who was it?
Nous saurons assez tôt.	We'll soon find out.
Hey!	Hey!
Les bruits bizarres !	Lights!
Les bruits bizarres !	Lights!
Des algues !	Seaweed.
- Où est le juge ?	- Where's the judge?
- Moi aussi.	- So did I.
Tiré dessus?	- Shot?
Que t"avais-je dit ?	What did I tell you?
- Quoi ?	- What?
C'est mon père.	- Yes.
C'est le mien.	It's my own.
- Par qui?	- By whom?
Sur la côte.	Don't you remember?
Vrai?	True?
Oui.	Yes.
- Entendu.	Agreed.
Une minute.	Now wait a minute.
Je préfère ne pas en parler.	I'd rather not talk about it.
Je ne vois pas pourquoi.	- I don't see why.
- Vous le verrez, vous le verrez.	- You will. You will.
Oui.	Right.
Oui.	Right.
Oui.	Right.
Oui ! J'attendrai !	I get it!
- Attends.	- Oh, wait a minute.
- Oh non !	- Oh, no!
Bonne nuit, messieurs.	Good night, gentlemen.
Certainement.	I'm sure I will.
Depuis quand êtes-vous ici?	How long have you been out there?
Pas si fort.	Shh. Not so loud.
Depuis quand êtes-vous ici?	How long have you been out there?
De toi.	You.
Et qu'a-t-il dit ?	- What about me?
Oui, il l'a dit.	- Yes, he did.
- Oui, absolument.	Yes, he was.
Écoutez donc !	Listen!
Ne tirez que si vraiment nécessaire.	Don't shoot unless you have to.
- Tiens.	I'm going to find out.
- Prenez l'arme.	- Take the gun.
Les temps ne sont plus les autres.	You go first!
Dis donc, Vera... !	Come on, Vera!
Un, deux, trois...	One. Two. Three.
Qui est là?	Who's there?
Lombard !	Lombard!
- Où ça ?	- Where?
Oui ! J'attendrai !	I get it!
J'ai deviné que c'était vous.	But I thought it was you.
- Exactement.	- Exactly.
- Laquelle ?	- What is it?
Je ne sais pas.	- Oh, I don't know.
Oui, je vois bien.	Yes, I know what you mean.
Nous saurons assez tôt.	We'll soon find out.
Que vois-tu ?	What do you see?
Qu"est-ce que c"est ?	What is it?
C'est impossible.	- It's impossible!
- Fais-moi voir ça.	- Let me see!
Qu'y a-t-il ?	What is it? What is it?
Comment allez-vous ?	Tell me.
Regarde !	Look!
Tu t'es levé à quelle heure?	- For hours?
- Vous.	- You.
- Et vous.	- And you.
N'avancez pas plus près !	Don't come any closer!
- Quel est votre nom?	- What is your name?
Il doit y avoir une explication.	There's got to be an explanation.
Oh oui, voilà.	Yes, that's it!
Je l'ai prévu aussi.	Oh, that's been taken care of.
Dix?	Ten?
Et vous ?	Why did you?
Bonjour.	Good morning.
Allez les appeler.	You call them.
Merci monsieur.	Thanks, mister.
Vous voulez autre chose ?	- Want anything else?
- Non.	- No.
Hé, vous !	Hey, you!
- Moi ?	- Me?
- Est.	East.
De Los Angeles ?	LA?
- Peut-être.	- Maybe.
- Sans blague.	- You don't say.
- Pas bavard, hein ?	You're not much of a talker, are you?
Éteignez-le !	Turn it off!
Une sacrée époque.	Those were the days.
- On rentre.	- Let's go home.
- Quoi ?	- I don't get you.
Mais pas maintenant.	But not now.
- Peut-être.	- Maybe.
Mais et moi ?	But what about me?
- Je croyais que tu m'aimais.	- I thought you loved me.
"Au revoir.	So long.
- Pourquoi pas ?	Sure, why not?
Bonsoir.	Good night.
J'ai 6 $.	Ten bucks.
"Merci."	Thanks.
C'est quoi ?	What was it?
Un appel longue distance.	Long distance.
Ah bon ?	You do?
Moi et toi...	Yeah.
l'Argent	Money.
Tu sais ce que ça fait ?	You know what that is.
- Tu vas loin? - Assez.	- How far are you going?
- A Los Angeles.	- L.A.
Tu viens d'où ?	- Where are you coming from?
- De New York.	- New York.
Hein ? Quelle bête !	What an animal!
Moi et toi...	Yeah.
J'avais tort ?	Was I wrong?
2 millions !	- Two million.
C'est ce que je vois.	Yeah, I can see that.
- C'est dur.	That was tough.
Moi, je mangeais.	I ate.
- Ça te plaît ?	- How do you like that?
Vous voulez autre chose ?	- Want anything else?
Votre monnaie, monsieur.	Your change, sir.
Je suis occupé.	Call again.
- Êtes-vous blessé ?	Are you hurt?
- Je l'écouterai.	I'll listen to it.
-Non, ce n'est pas que pour ça.	Not only that.
J'ai perdu toute notion du temps.	I lost all track of time.
- Non.	- No.
Non...	No ...
Plus tard.	Later.
Il y avait une femme.	There was a woman.
- De Los Angeles.	- Los Angeles.
-C'est ce que je craignais.	- That's what I was afraid of.
- Qu'as-tu dit ?	- What did you say?
- Non.	- No.
- Non.	- No.
On me la fait pas !	You're not fooling anyone.
- Tu m'as entendu.	- You heard me.
Pas l'ombre d'un doute:	There was no doubt about it.
alors, j'attends.	Well, I'm waiting.
Tiens ?	Well?
C'est la vie.	That's life.
Pas à ma connaissance.	Not that I know of.
Ferme-la.	- Shut up.
Je ne t'aime pas.	I don't like you.
- Je ne suis pas un meurtrier.	- I'm not a murderer.
- Ça suffit !	- Oh, skip it.
- Que veux-tu dire ?	- What do you mean?
Je n'ai jamais pensé à ça.	I never thought of that.
- Je ne veux pas que tu te perdes.	I don't want you to get lost.
"Merci."	Thanks.
Cette nouvelle me soulage.	I'm relieved.
Yep.	Yep.
- D'accord.	- OK.
Le crayon rouge pour la fille,	I invented it.
Tu dois l'être.	You must be.
Il m'énerve.	It gets on my nerves.
Oubliez ça.	Forget it.
Bois un petit coup.	Have a drink.
Tu l'as pas tué.	You didn't kill him.
"Merci."	Thanks.
- Tu as peut-être raison.	- Maybe you're right.
- J'ai toujours raison.	- I'm always right.
Sûr qu'elle y est !	Sure is.
Oui, professeur.	It's a profession.
Plus d'un homme par jour.	Think of that.
Fatigué de penser !	I'm tired of thinking.
Je sais de quoi je parle.	I know what I'm talking about.
Reste à savoir quand.	It's only a question of when.
Moi et toi...	Yeah.
Bien ?	Like you?
Je vous aime.	I love you.
Je vais au lit.	I'm going to bed.
Tais-toi !	Shut up.
- Allez.	Come on.
- Je vous l'achète.	I want to buy it.
- Ça dépend du prix.	- If the price is right.
- Oui.	- Yup.
Alors ?	- Well ...
Changer d'avis ?	Change your mind?
Allons-y.	- Let's go.
Merci.	Thank you.
Regarde ça.	Take a look at that.
- Oh que si !	- Yes, you will.
Tu me prends pour un fou ?	You think I'm crazy?
Pardon.	Excuse me.
Je ne le ferai pas.	And I won't do it.
Un peu que tu marcheras !	I think you will.
Non.	No.
Peut-être, peut-être.	Maybe. Maybe.
- Oui.	- Yeah.
Bonne chance à tous.	Alright, then.
De l'information?	Information?
"Merci."	Thanks.
- Et alors ?	- So what?
Laisse-moi tranquille !	- Vera!
D'accord.	Alright.
-Ne me le dis pas.	- Don't tell me.
Vera !	Vera!
Ironie du sort:	Isn't that a laugh?
Bien.	Very well.
- Bonjour. - Chris...	Chris.
Félicitations.	Congratulations.
Merci.	- Thank you.
Merci.	- Thank you.
Merci.	Thank you.
Merci.	Thank you.
Bonsoir.	Good night.
Regarde-moi ça.	Look.
- Et alors ?	What do you find?
J'ai trop bu.	I drank too much.
Bonsoir.	Good night.
- Non, attends, attends.	- No, wait, wait.
Agent !	Agent!
Agent !	Agent!
- Là-bas.	- Over there.
Je ne la connais pas.	- I don't know it.
Pete.	Wait here.
Allons voir.	We go there.
Salut, Kitty.	Hello, Kitty.
Vous avez vu Johnny ?	Have you seen Johnny?
Deux cafés.	Two coffees, please.
Seulement un ryo ?	Only one?
- Oui, oui.	- Yes, yes.
Merci.	Thank you.
Kitty...	Kitty.
En bref...	In short...
Ah oui ?	Do you believe?
- Moi ?	- Me?
- Non.	- No.
Eh bien...	Well...
Oui.	Yes.
Non.	No, no, not.
Quelle heure est-il?	What time is it?
Merci.	Thank you.
Christophe.	Christopher.
Ma femme...	My wife...
Non.	No.
C'est mon père.	- Yes.
C'était terrible.	It was terrible.
Cinq ans.	Five years.
Et...	And...
Tu en veux un ?	Do you want one?
- De toi.	- Of you.
La voyez-vous?	Do you see it?
Johnny !	Johnny!
C'est de ce côté-là.	It is this way.
Non.	No.
Oui je comprends.	Yes, I understand.
Tu le sais déjà.	You already know.
Intéressant.	Interesting.
- Oubliez ça	- Forget it.
Kitty, je t'en prie.	Kitty, please.
Chris !	Chris!
Il faut que je vous dise.	I have to tell you something.
- Quoi ?	- What?
je vous ai trompé.	I have deceived you.
- De combien as-tu besoin ?	How much do you need?
Non, merci.	No, thank you.
Merci.	Thank you.
-Vous avez bu ?	Have you been drinking?
Christophe.	Christopher.
Christophe.	Christopher.
Que faites-vous ?	What are you making?
Vous êtes aveugle?	Are you blind?
Lequel ?	- Which?
Bien sûr.	Of course.
- Femme !	- Woman!
- Tiens...	- Here.
Alors ?	Is he?
-Allez...	Go...
Whisky ?	Whisky?
Avance !	Go, go, go...
Ça pouvait l'être.	It could be.
Chris !	Chris!
- Vous avez de la compagnie.	You have company.
Johnny.	Johnny...
Comment est-ce ?	How is it?
Oui.	Yes.
Son attitude n'était pas suspecte ?	Perhaps.
Es-tu heureuse ?	Are you happy?
Mille dollars ?	A thousand dollars?
Et pourquoi pas ?	Why not?
Oui, je la connais aussi.	Yes, I know it.
- Je vais les chercher.	- I will get it.
- Au revoir.	- Good-bye.
Je ne la comprends pas.	I don't understand it.
Marius, tu ne m'aimes pas.	You don't love me.
Non?	No?
- Non.	- No.
Et maintenant, quoi ?	And now, what?
Bonsoir.	Good night.
- Salut, Nick.	Hello, Nick.
Sont-ils bons, vieux voleur ?	Are they good?
C'est important ?	Is it important?
Nick.	Nick.
- Quel musée ?	What museum?
Mon Dieu.	My God.
