今からそれを話してあげよう	I will tell you...
待て！	"Wait!"
待て！	"Wait!"
夜・・	Night...
ふたたび夜・・	Night...
チェザーレよ！	Cesare!
どんなの？	Describe it.
おい　私は被害者だぞ	Hey!
"毒"	Poison.
輝く星に願いをかければ	When you wish upon a star
どんな人の望みでも	Makes no difference who you are
いつも夢を追う人なら	If your heart is in your dream
どんな祈りも必ず届く	No request is too extreme
輝く星に願いをかければ	When you wish upon a star
心の夢をかなえてくれる	As dreamers do
運命は やさしい女神	Fate is kind
恋する者を訪れて	She brings to those who love
実らせてくれる	Their secret longing
青空をさく稲妻のように	Like a bolt out of the blue
いい歌だ	Pretty, huh?
私は信じています	Well, I didn't either.
すてきな夜で	It was a beautiful night.
まるで絵のようでした	Pretty as a picture.
暖炉の火が いかにも気持ちよさそうです	It was a shame to see a nice cheerful fire like that going to waste.
どうするかな	So what do I do?
入ろう	I go in.
まずは偵察	I looked around.
誰もいない様子で ホッとしました	Soon as I saw there was no one about, I made myself at home.
まるで おとぎの国でした	Well, sir, you never saw such a place.
人形でした	A puppet!
糸で手足を動かす あやつり人形です	You know, one of those marionette things, all strings and joints.
かわいいね	Cute little fella.
いい木だ	Good piece of wood too.
さてと	Well, now.
もうひと息だ	It won't take much longer.
あと少しで完成だ	Just a little more paint and he's all finished.
いいぞ	Very good.
へそ曲がりもいるさ	Well, you can't please everybody.
ピノキオだ	Pinocchio!
どうだ　フィガロ	Do you like it, Figaro?
だめ？	No?
クレオは賛成だね	You do, don't you, Cleo?
どうだ	Do you like it?
決まった	That settles it!
ピノキオだ	Pinocchio it is!
動かしてみよう	Come on, now, we'll try you out.
教授　音楽を	Music, Professor!
小さな木の手足	Little wooden feet and best of all
転んでも平気な体	Little wooden seat in case you fall
よく動く	How graceful!
クレオ　ピノキオだよ	Cleo, meet Pinocchio.
挨拶して	Say, "How do you do?"
フィガロにも	Say hello to Figaro.
ほら ごらん	You see what happens?
おいで	Up we go!
フィガロが やきもちをやいてるぞ	You know, Pinocchio, I think Figaro is jealous of you.
何時かな	I wonder what time it is.
こんな時間か	It's getting late.
おやすみ　ピノキオ	Good night, Pinocchio.
フィガロ	Figaro.
早く	Go on.
私も横になろう	This is my idea of comfort.
快適 快適	Solid comfort.
あれが本当の子供ならな	Wouldn't it be nice if he was a real boy?
本当の子なら	A real boy!
うるさい！	Quiet!
わかれば結構	After all, enough's enough.
今度は何だ	Now what's up?
いったい何事だ	Hey, what's going on here?
なんと妖精だ	As I live and breathe, a fairy!
木のあやつり人形 起きなさい	Little puppet made of pine, wake.
命を授けます	The gift of life is thine.
ぼく 動ける	I can move!
話もできる	I can talk!
それに歩ける	I can walk!
なぜ？	- Why?
ぼく 本物の子供？	- Am I a real boy?
楽じゃない	That won't be easy.
善悪？	Right and wrong?
どうすれば わかるの	But how will I know?
良心に聞くの	- Your conscience will tell you.
良心って？	- What are conscience?
良心も知らないのか	- What are conscience!
教えてやる	I'll tell ya!
君が良心？	- Are you my conscience?
私が？	Who, me?
こうですね	No tricks now.
立って　クリケット卿	Arise, Sir Jiminy Cricket.
こりゃすごい	Say, that's pretty swell.
ピッカピカだ	Gee... thanks.
そのうちね	- Well, we'll see.
そう思うわ	- I shouldn't wonder.
では金のを	- Make it a gold one?
たぶんね	Maybe.
よし	All right.
では掛けて	Sit down, son.
わかる？	- Understand?
こう？	Like this?
こうかな	Like this?
なってない	No, son.
よく聞いて	Now, listen.
困った時は呼びなさい	When you get in trouble and you don't know right from wrong
口笛 吹いて	Give a little whistle
口笛 吹いて	Give a little whistle
誘惑に負けそうになったら	When you meet temptation and the urge is very strong
口笛 吹いて	Give a little whistle
口笛 吹いて	Give a little whistle
口をすぼめて思い切り	Not just a little squeak Pucker up and blow
口笛 吹いて	Give a little whistle
口笛 吹いて	Give a little whistle
いつでも良心が道案内	And always let your conscience be your guide
いつでも良心が道案内	And always let your conscience be your guide
誰だ ぼくだよ	- Who is there?
お前か	Oh, it's me.
誰かいるぞ	There's somebody in here.
どこかにいる	He's in here somewhere.
ここだよ	Here I am!
ピノキオ	Pinocchio.
どうして床に？	How did you get down here?
落ちたの	- I fell down.
そうか	- Oh, you did.
しゃべったぞ	You're talking!
面白かった	Gee, you're funny.
もう一度	Do it again!
良心？	- A conscience!
かわいい	Yeah, cute.
お祝いをしなきゃ	This calls for a celebration.
音楽だ	Music!
お前も押して	You start one, Pinocchio.
パーティだ	Oh, boy.
私にも	Mind if I cut in?
きれいだ	Ooh, nice.
見て　きれい	- Look!
水をくれ	Help!
忙しい夜だった	Little man, you've had a busy night.
さあ もう目をつぶって おやすみ	Now, close your eyes and go to sleep.
なぜ？	Why?
なぜ？	Why?
なぜ？	Why?
それは つまり...	- Because.
少し じっとして	Stand still now.
あの子たちは？	- What are those?
そうだ	- Yes.
急いで	But hurry now.
さあ 行きなさい	Run along now.
お前はいいんだ	School is not for you.
知識の泉へ急ぐ子供だ	Thirsty little minds rushing to the fountain of knowledge.
学校は大事なものだぞ	School, a noble institution.
こりゃ ひと儲けできるぞ	A thing like that ought to be worth a fortune to someone.
どうしたものか	Now let me see.
これだ	That's it!
聞け	- Listen.
だめだ	No, no, stupid.
乱暴するな	Don't be crude.
俺に任せろ	Let me handle this.
来たぞ	Here he comes.
何とも申し訳ない	Oh, I'm terribly sorry.
大丈夫	- I'm all right.
よかった	- Oh, splendid.
見ろ　学者の先生だ	Look, Giddy, a man of letters.
どうぞ	- Here's your book.
学校へ行くの	- I'm going to school.
学校？	School.
なるほど	Ah, yes.
やはり	- No?
名声？	- Fame?
名前は？	- What is your name?
ハイ ディ ドゥル ディ ディー ぼくはスター	Hi diddle dee dee An actor's life for me
ハイ ディ ドゥル ディ デイ 面白おかしく	Hi diddle dee day An actor's life is gay
何だ	- What was that?
どこに	Up where?
怖いことなんか何もない	Why, there's nothing up there to be afraid of.
ここだ	Over here.
やつがそうだ	- Well, that's him.
正直ジョン？	Honest John?
いたいた	Ah, there you are!
何だっけ　そうだ	Now, where were we?
さて世紀のショー　最後の 出し物をお贈りするのは―	Ladies and gentlemen, to conclude the performance of this great show,
だが本当に大丈夫かね	I hope so.
世にもまれな人形　ピノキオ	The one and only Pinocchio!
いい子いい子　頑張れよ	Cute kid.
石ころまでも 笑いかけてくる	I want the world to know Nothing ever worries me
ぼくは自由	There are no strings on me
スターに良心は必要ない	What does an actor want with a conscience anyway?
あの子に何があったんだ	What could have happened to him?
こんな時間までどこに	Where could he be at this hour?
もう一度 捜してみよう	I'd better go out again and look for him.
ブラボー　ピノキオ	- Bravo, Pinocchio!
受けたね	- They like me.
大当たりだよ	You are colossal!
その顔を世界に売ってやる	Your face, she will be on everybody's tongue.
本当に？	- Will she?
こりゃ何だ	What's this?
こいつはお前にやろう かわいい坊や	For you, my little Pinocchio.
ぼくに？	For me?
ありがとう	Gee, thanks!
帰って父さんに見せなきゃ	I'll run right home and tell my father.
帰るだと？	Home?
じゃ また明日	- I'll be back in the morning.
ふざけるな	Going home.
モンテカルロ	Monte Carlo.
いや　いやだ	- No, no!
やるんだ！	- Yes!
ガッポリ稼いでもらうぞ 俺のために	You will make lots of money... for me!
うるさい	Quiet!
いやだ	No! No, wait!
それ行け	Get along there.
このまま消えよう	I'll just go out of his life quietly.
それはないよ	Sure! Why not?
どうした	What's happened?
本当か	Oh, is that so?
私の声？	That's what I said.
型が古いらしい	Must be one of the old models.
開かないの？	You mean, you can't open it?
ああ	Yeah.
もう父さんに会えないね	Guess I'll never see my father again.
鼻をかんで	Come on, blow.
それでいい	Thatta boy.
例の星だ	Hey, that star again!
どう言おう	- What'll I tell her?
正直に言うんだ	- You might tell her the truth.
学校はどうしたの	Pinocchio, why didn't you go to school?
学校？	- School?
正直に言え	- Go ahead, tell her.
行く途中で会ったの	I was going to school 'til I met somebody.
誰に？	- Met somebody?
怖かったでしょ	- Weren't you afraid?
まさか	- No!
本当です	- Yeah!
逃げたの？	- How did you escape?
いいえ	- I didn't.
どうして	What's happened?
ハイ ディドゥル ディ ディー ぼくはスター	Hi diddle dee dee An actor's life for me
ハイ ディドゥル ディ デイ 面白おかしく	Hi diddle dee day An actor's life is gay
いいか	You see--
悪い子供？	- Stupid little boys?
裏切るなよ	- No, sir.
偉いぞ	- You'd better.
いいぞ	Now you're talkin'!
君か	Oh, hello.
まさか	- He did?
絶対おかしい	Bless my soul.
やはりだ	- I knew it!
何も	- Nothing.
アレルギー？	- Allergic?
おもしろ島？	- Pleasure Island?
俺の切符をやろう	I'm giving you my ticket.
どうぞ	- Here.
ハイ ディドゥル ディ ディー 楽しい島	Hi diddle dee dee It's Pleasure Isle for me
やれやれ こりないね	Well, here we go again.
お前は？	What's yours?
ピノキオ	Pinocchio.
ケーキにパイ アイスクリーム	Get your cake, pie, dill pickles and ice cream.
なぜ？	- Why?
下へ行って箱の用意だ	Now get below and get them crates ready.
したい放題すりゃ ロバになるんだ	Give a bad boy enough rope and he'll soon make a jackass of himself.
みんな どこだ	Where is everybody?
ピノキオ	Pinocchio!
どこにいる	Hey, where are you?
ほんと	Yeah!
まったくよ	It sure is!
きくだろ？	Some fun, huh, kid?
ピノキオ！	Pinocchio!
これで本当の子に？	How do you ever expect to be a real boy?
なんてざまだ	Look at yourself.
玉突き	Ow!
下ろせ	Put me down!
何だって	What?
バッタ？	Grasshopper?
親友？	- Your best friend?
結構　好きにしろ	Okay, that settles it.
どこからロバが	Where'd all the donkeys come from?
お前の名前は？	And what's your name?
入れ	In you go!
いい値で売れそうだ	You boys'll bring a nice price.
よし　次だ	All right, next!
アレキサンダー	- Alexander.
うるさい！	- Quiet!
子供か	"Boys"?
ふざけた虫だ	Ha!
良心？	Conscience.
ほんとだ	You sure do!
ロバそっくりだったぜ	Hey, you laugh like a donkey.
俺の声か	Did that come out of me?
母ちゃん	Mama!
間に合うかな	- I hope I'm not too late.
どうしよう	What'll I do?
君もか	Oh, you too!
飛び込め	You gotta jump!
もちろん	Sure.
危機一髪だった	I thought we'd never make it.
家へ帰ろう	Come on, let's get home.
眠ってるんだ	Hey, maybe he's asleep.
ピノキオ　ここへ	Pinoke, come here.
ごらん	Look.
いない	He ain't here.
大丈夫　きっと近くにいるよ	Don't worry, son, he probably hasn't gone far.
手紙だ	- It's a message.
どんな？	- What's it say?
父さんのこと	- It's about your father.
どこなの	- Where is he?
どこへ	Where you going?
捜しに行く	I'm going to find him.
餌になるなら一緒にだ	I may be live bait down there, but I'm with ya.
行くぞ 出発	Come on, let's go.
下の連中　落ちるぞ	Look out below!
道をあけて	Gangway, down there.
またね	Well, so long.
父さん	Father!
ピノキオ　待ってくれ	Hey, Pinoke, wait for me!
父さん	Father!
父さん	Father!
何だよ	Hey, what the--
すごい威力	That got 'em.
父さん	Father!
やあ	Oh, hello.
行くんだ	Break it up now.
何だよ　こら	Hey, what the--
怪物クジラはどこ	Could any of you tell me where to find Monstro?
もう何日も獲物なし	Not a bite for days.
これではわしらも長くない	We can't hold out much longer.
いい子だったのに	He was such a good boy.
やはり だめだ	It's hopeless, Figaro.
取り尽くしたんだ	There isn't a fish left.
やって来たぞ！	Here they come!
箱に入れろ　フィガロ	Keep them in there, Figaro!
待って	Hey!
逃げなきゃ	We got to get out of here!
すごい数だ	Never saw so many!
また１匹	Here's another one!
当分食える	Enough for weeks!
大物だ	Here's a big one.
箱に入れておけよ	Keep them in there, Figaro!
また１匹	- Here's another one.
父さん	Hey, Father!
父さん	- Father!
父さん	- Father!
帽子を	Let me take your hat.
ピノキオ	Pinocchio!
その耳だ	- Those ears!
耳？	- Huh?
何があったんだ	What's happened to you?
こら　やめろ	Hey! Cut it out!
イカダか	- A raft?
だめだめ	No, no, no, no.
いらないよ　出るから	We won't need it.
やっと開いた	Well, it's about time!
とても無理だ	- It won't work!
しっかり こいで	Hang on!
お大事に	Gesundheit.
引き戻される	- We're going back!
やったぞ	We made it!
言った通りだ	I told you he'd be furious!
消えた	- He's gone!
どこに	- Where did he go?
危ない！	Look out!
つかまれ	Hang on!
戻ってくる　早く	He's coming back.
バックして	Let's go back!
危ない	Look out!
跳べ	Jump!
父さん　父さん	Father! Father!
わしの息子	My boy.
勇敢で正直で 思いやりがあれば 本当の子供になれます	Prove yourself brave, truthful and unselfish, and someday you will be a real boy.
父さん	Father!
死んでないよ	No, I'm not.
いや　死んだんだ	Yes, yes, you are.
寝ておいで	Now, lie down.
本物だ	- I'm real.
本物の子供だ	I'm a real boy!
生きてる	You're alive!
お祝いをしなきゃ	This calls for a celebration!
音楽だ　盛大に頼むぞ	Professor, lots of music!
感謝します	Thank you, milady.
何よりのご褒美	He deserved to be a real boy.
私まで	- Well, I'll be!
"公認　良心"	My, my!
起きて！ - あぁ、どうしたね？	Wake up.
- 起きて！	- What now?
森で何が起こってるんだね？ - 起きて！	What's going on around here?
起きて！	- Wake up.
- いよいよなの！	- It's happened.
- 早く！	- Come on.
急いで！ ！	You better hurry up.
さぁ皆さん、よくみて	Well, look.
- まぁ・・・！ ！	- Well.
- うふふ、可愛らしいでしょう？	- Isn't he cute?
おめでとう！	You're to be congratulated.
- おめでとう！	- Yes, congratulations.
- おめでとう！ ！	- Congratulations.
皆さん、どうもありがとう	Thank you very much.
みてみて！	Look.
立ち上がろうとしてる！ ！	He's trying to get up.
大丈夫よ	Thumper.
そうみたいね	Well, he is.
あなたはだぁれ？	Aren't you?
行くよ	Come on.
テンパー　来なさい！	Thumper.
- おはようございます	- Good morning.
ごきげんよう	Goodbye.
おはよう	Good morning.
- 大丈夫！ ？	- What's the matter?
- どうしたの？ 王子様	- What happened?
- 怪我しちゃった？	- Is he hurt?
テンパー！	Thumper.
ほら、起き上がって！	Come on, get up. Get up.
- がんばれ	- Get up.
- がんばれバンビ！	- Try again.
テンパー！	Thumper!
来いよー！	Come on.
王子様ならできるだろー？	You can do it.
こんな感じ	Like this.
とりさん	Bird.
と・り・さ・ん！	Bird.
とりさん！ ！	Bird.
言えたよ！	He talked.
鳥さん！ ？	Bird.
チョウチョさん？	Butterfly?
チョウチョ・・・	Butter...
チョウチョさんだ！	Butterfly.
- そう、とても可愛いんだ	- It's pretty.
可愛い	Pretty.
お花さん！ ？	Flower.
僕の事？	Me?
- 彼は・・・実は・・・	- He's a little...
- どういたしまして	- That's all right.
なかなかいい感じだね？	I don't mind.
可愛い！	Pretty.
まぁ・・・お上手	Gosh.
草地？	Meadow?
- それをどこで聞いたの？	- Where did you hear that?
そうね、彼は正しいわ	Well, he's right.
えぇ、そうね	Perhaps.
だから今は静かにね？	Hush now.
みんな近くにいるの	We're almost there.
- 待って！	- Wait.
ここで待ってて	Wait here.
大丈夫よ！	It's all right.
こっちにおいで！	Come on.
こんにちは！	Hello.
そっちのは美味しいよ！	It's delicious.
これはご馳走なんだ	That's the good stuff.
ティンパー！	Thumper.
はい、ママ？	- Yes, Mama?
あなたのお父さんは 何をあなたに言いましたか？	- What did your father tell you?
なんの事？	About what?
そう、それ！	Oh, that one.
こんにちは、バンビ！	Hello, Bambi.
「こんにちは」って言ったわ！	I said hello.
怖くないでしょう？	You're not afraid, are you?
さぁ、「こんにちは」と言いましょう	Go on, say hello.
こ・・・んにちは	Hello.
怒ったぞ！	You.
そうね？	Yes, I know.
バンビ！	Bambi.
ママ！ ！	Mother.
バンビ！	Bambi.
ママ！	Mother.
こっちに	Come on.
もう大丈夫よ、ここは安全	It's safe now.
ママ、見て！ ！	Mother, look.
- 雪？	- Snow?
- そう	- Yes.
こっちに来いよ！	Come on.
大丈夫だからさー！	It's all right.
ほら、見て！	Look.
こっちに来いよ！	Come on, get up.
早く起きて！	Like this.
起きろー！　"お花さん"！	Wake up.
お花さんはどうして眠ってるの？	What do you want to do that for?
じゃぁ、おやすみ・・・	Well, good night.
大丈夫、そんなに続かないわ	But it won't last forever.
えぇ・・・みんなそうなのよ	Yes, I know.
見て	Look.
バンビ！	Bambi.
早く！ ！	Quick.
早く！ もっと早く！	Faster.
バンビ！ ！	Faster, Bambi.
前を見て！ 振り向かないで！	Don't look back.
走り続けて！	Keep running.
走り続けて！ ！	Keep running.
やったよ	We made it.
うまく・・・・	We...
ママ？	Mother.
ママ！ どこにいるの！ ？	Mother, where are you?
ママは・・・ もうおまえとは一緒にいられないんだ	Your mother can't be with you anymore.
来るんだ	Come.
私の息子よ	My son.
なんだぁ！ ？	Wait.
今度はなんだ！ ？ なんだ！	What now?
ねえ！	Hey.
嫌になるね！	Scat.
もう春は終わりだ！	There.
もう好きにしろ！	Oh, what's the use?
もう、うるさーい！ ！	Stop it.
おまえら、他所でやれ！	Get out of here.
他所で！	All of you.
おまえもだ！	And you, too.
バンビ！	Bambi!
やぁ、バンビ！	Hello, Bambi.
僕を覚えてるかい！ ？	Remember me?
テンパー！	Thumper.
そうさ！ ！	Right.
こんにちは、お兄さんがた	Hi, fellas.
お花さん！ ！	Flower.
うふふ	Yeah.
それからそれから・・・・	And then you know what?
- そりゃひどい！	- Terrible.
こいつは誰にでも起こる可能性があるんだ	It can happen to anybody.
僕にもないよ！	- Me neither.
ないね	- Me neither.
ラブラブかよ！	Twitterpated.
こんにちは、バンビ。	Hello, Bambi.
あなたは私を覚えていないのですか？	Don't you remember me?
バンビ・・・	Bambi.
And you・・・ (そして、あなたも・・・・)	And you
急げ！	Hurry.
私について来い！	Follow me.
聴こえる！	Listen.
- どんどん近づいてるわ - シー！	- He's coming.
静かに！	- Hush.
静かにして	Be quiet.
- 落ち着いて！	- Be calm.
興奮しないで！	Don't get excited.
- 跳び上がっちゃダメだ！	- No.
人間はすぐそこよ！	He's almost here.
もう耐えられない！ ！	I can't stand it any longer.
バンビ！	Bambi.
立て	Get up.
おまえは立たなければいけないんだ！	You must get up.
立て！	Get up.
立ち上がれ！	Get up.
私と一緒に来い	Now, come with me.
バンビ	Bambi.
起きろよ！	Wake up.
今度は何だ？	What now?
- いよいよなんだ！	- It's happened.
- いよいよだよ！	- Happened?
まぁ・・・皆さん・・・	Oh. Well.
よく見えるわ	Look.
可愛い二人・・・	Two of them.
チャールズ・モーリィ 友人さ	An old friend of mine.
- ほう、そうでしたか	- Oh, I didn't know.
- すいませんね	- Thank you.
- なんだ？	- Yes?
エセル	Ethel.
気の揉めるはなしさ	Makes me nervous.
これも！	Here!
さあ	I don't know.
それから？	Then what happened?
いったいどうなっている？	What's going on here?
レコードだ	It's on the record.
- 私でございます	- I did, sir.
- なぜ？	- Why?
知らなかった	I ...
だから来るんじゃなかったって！	I told you we shouldn't have come here!
- おだまり！	- Shut up!
彼はどういう人物かね？	What kind of a man is he?
彼を知っている者は？	Who knows him?
- 言ったじゃないか！	- I told you!
わかりました	Yes, sir.
唯一直接本人からのものです とても妙ですな	Very peculiar.
- 雇われたんだ	- I was hired.
- 誰に？	- By whom?
- 会ったのか？	- You saw him?
- いや、高額の為替を同封してきた	- No.
アンノウン（不明）	Unknown
嘘だ！	That's a lie!
思い出しましたぞ 一年前	Now I remember.
- 何があった？	- What happened?
同感です	I quite agree, sir.
- ございません	- No, sir.
すばらしいじゃないか！	It's wonderful!
いやまったく！	Really!
- はあ？	- Huh?
何と言われたのじゃ？	What did you say?
- 動かない	- He's not moving.
- 先生は何と言われた？	- What did the doctor say?
- 死んだ	- Dead.
はあ？	What?
触るな！	Don't touch!
嗅いで	Smell it.
- 自殺ですか？	- Suicide?
先生！	Doctor!
おはようございます、将軍	Good morning, General.
おはよう	Good morning.
- どうしました？	- What?
- どうも不可解だ	- I don't understand it.
- ８つ	- Eight.
朝食は？	What about breakfast?
- なんだと？	- What?
- なんだって？	- What?
- 妻です	- His wife.
- はあ？	- Eh?
- 妻か	- Wife?
信じられんね	I don't believe it!
慌てなくていい！	Take your time!
- って何を？	- Got what?
- 俺もだ	- Me too.
直ちに 狂人が野放しである限り	Immediately.
聞いたか？	Do you hear that?
僕らもだ	So are we.
サー・ジョン！	Sir John!
- 誰もいない！	- Nobody!
どういうことだ	I don't understand it.
そうだ！	That's right.
- 居所は分ってます	- I know where he is.
何だ、どうした？	What is it, man?
- 思っていたことが	- I was expecting that.
火を見るよりも明らかに	Perfectly clear.
なすべきとやらがそれか？	Do you have to do that?
- 誰？	- Who?
誰だ？	Which one?
- それはない	- We don't.
- それを考えていた	- That's what I was thinking.
- 彼について知っていることは？	- What do we know about him?
事実だ！	That's a fact.
どうしてだね	I don't see why.
どうも	Thank you.
誰を疑ってる？	Whom do you suspect?
無理を言うな！	You can't do that!
時が経てばわかる	Time will tell.
それが何か？	What about it?
結構よ	No, thank you.
多ければ多いほど愉快	The more the merrier.
- 何でございましょう？	- Yes, sir?
おかげさまで	Thank you.
- もう言ったのか？	- Have you told him?
- はい	- Yes, sir.
ちょっと待て！	No wait!
開けろ！	Open up!
ドアを開けるんだ！	Open the door!
- 何のため？	- What for?
急げ！	Hurry up!
雨だ！	It's raining!
ご心配にはおよびません	Don't worry about me, sir.
いや、いい	Never mind.
- おやすみ	- Good night.
- おやすみ	- Good night.
- おやすみなさい	- Good night.
- おやすみなさい	- Good night, sir.
いないぞ！	She's not here!
どうした？ もう日が高い	What's wrong with that?
見て！	Look.
- なんだ？	- What's that?
- どこかな？	- Where is he?
ロジャース！	Rogers!
ロジャース！	Rogers!
- いない	- He's not there.
彼は酔っ払った挙げ句	He got drunk.
彼は死んだ	He's dead.
- まだだ	- No.
- 何？	- What?
- １、２、３、４、５、６	- One. Two. Three.
わかったぞ！	I get it!
いや違うな	No I don't.
いいえ、どうして？	No, why?
少年はどうしたの？	What happened to the boy?
わかったぞ！	I got it!
- 誰？	- Who?
- ロジャースさ	- Rogers.
先生が言ったとおり 事実！	Fact.
実践が必要だ	It takes practice.
もちろん	Of course.
ロンバード！	Lombard!
- そこで何をしてる？	- What you doing here?
- なぜだ？	- Why is that?
女はどうだい？	How about a woman?
彼女だ！	It's her!
どうする？	How do we know?
聞かれなかったから	Nobody asked me.
よし！	I've got him!
どこにあるか知ってるぞ	I know where it is.
- ないぞ！	- It's not here!
- 違う！	- Don't.
ないな	It's not here.
- どうしたんだ？	- What did you do with it?
- 貴様こそどうした？	- What did you do with it?
ご自分はどうなの？	What about yourself?
あらどうして？	Why not?
そうします	I shall.
知らんよ	I don't know.
- ヴェラ？	- Vera?
- これ以上近づくな！	- Don't come any closer!
- 彼女はどこだ？	- Where is she?
一言も言わん	I won't say a word.
これ以上寄るんじゃない！	Don't come any closer!
- 余計な心配をするな	- Don't worry about me.
- 行こう！	- Come on!
うるさいな	Don't bother me.
わかったぞ！	I get it!
- そのままそこにいろ！	- Stay where you are!
- なんですと？	- Why not?
- 誰だ？	- Who?
なるほど！	I see!
- それで？	- Now?
以上	That's all.
- 恐れ入ります	- Thank you.
- ヴェラ！	-Vera!
-誰だ？	-Who is it?
- 君はどこにいた？	- Where have you been?
あんたの部屋？	Your room?
- なにがあった？	- What happened to you?
- なにか聞かなかった？	- Did you hear anything?
ヴェラ！	Vera!
ヴェラ！	Vera!
どうした？	What happened?
- 誰？	- Who?
- 何者だ？	- Who was it?
すぐにわかる	We'll soon find out.
おい！	Hey!
灯り！	Lights!
灯りを！	Lights!
海藻だ	Seaweed.
- 判事はどこだ？	- Where's the judge?
- 俺もそうだ	- So did I.
- 銃声？	- Shot?
言わんこっちゃない	What did I tell you?
- 何が？	- What?
- そうだ	- Yes.
僕のだ	It's my own.
- 誰だと？	- By whom?
忘れたのか？	Don't you remember?
真実ですか？	True?
ええ	Yes.
同意	Agreed.
ちょっと待った！	Now wait a minute.
話したくありません	I'd rather not talk about it.
- なんのことだか	- I don't see why.
- そうでしょうとも	- You will. You will.
そのとおり	Right.
そのとおり	Right.
そのとおり	Right.
わかったぞ！	I get it!
- おっと待った	- Oh, wait a minute.
- いやいや	- Oh, no!
諸君、また明日	Good night, gentlemen.
私はできます	I'm sure I will.
どれくらいそこにいたの？	How long have you been out there?
しーっ、声が高い	Shh. Not so loud.
そこにどれくらいいたの？	How long have you been out there?
あなたよ	You.
- じゃあ私は？	- What about me?
- いいえ、いたわ	- Yes, he did.
いいえ、殺された	Yes, he was.
あれは？	Listen!
必要なときまで撃つな	Don't shoot unless you have to.
はっきりさせるぞ	I'm going to find out.
- 銃を	- Take the gun.
先に行け！	You go first!
さあ、ヴェラ！	Come on, Vera!
１、２、３ インディアンは３つだけ	One. Two. Three.
誰だ？	Who's there?
ロンバード！	Lombard!
- どこだい？	- Where?
わかったぞ！	I get it!
だってあなたと思ったから	But I thought it was you.
- それだ	- Exactly.
- どうかした？	- What is it?
- よくわからない	- Oh, I don't know.
まあ言いたいことは分かる	Yes, I know what you mean.
すぐに探し出すさ	We'll soon find out.
何が見えて？	What do you see?
何なの？	What is it?
- あり得ない！	- It's impossible!
- 見せて！	- Let me see!
何よ、何なの？	What is it? What is it?
おしえて	Tell me.
見て！	Look!
- 数時間？	- For hours?
- きみと	- You.
- あなた	- And you.
これ以上近寄らないで！	Don't come any closer!
- 名前は？	- What is your name?
これには訳がある	There's got to be an explanation.
そういうことか！	Yes, that's it!
もう手配済みです	Oh, that's been taken care of.
１０？	Ten?
あなたこそどうして？	Why did you?
おはよう	Good morning.
呼んでみろ	You call them.
どうも そこで降ります	Thanks, mister.
- 他に御注文は？	- Want anything else?
- ない	- No.
おい あんた	Hey, you!
俺か？	- Me?
東	East.
LAかい？	LA?
- まあな	- Maybe.
- そうかい！ - そいつがな...	- You don't say.
話すの嫌みたいだな	You're not much of a talker, are you?
そうだ 止めろ！	Turn it off!
そんなあの頃...	Those were the days.
もう帰りましょ	- Let's go home.
どういう意味さ	- I don't get you.
でも今はだめ	But not now.
- 私は成功するわ	- Maybe.
- だとして 僕はどうなる？	But what about me?
- 僕を愛してると思ってた	- I thought you loved me.
さよなら	So long.
もちろんするさ	Sure, why not?
おやすみ	Good night.
10ドルだぞ	Ten bucks.
どうも	Thanks.
なぜだろう？	What was it?
遠距離を頼む	Long distance.
何だって？	You do?
うん	Yeah.
金...	Money.
金とは何か ご存じだろう	You know what that is.
- どこに行くんだ？	- How far are you going?
- LAさ	- L.A.
- どっから来た？	- Where are you coming from?
- ニューヨークさ	- New York.
まさに猛獣だ！	What an animal!
ああ	Yeah.
まずいと思うか？	Was I wrong?
見すぎてる	- Two million.
そうみたいだ	Yeah, I can see that.
すごいな！	That was tough.
俺は食べるだけだ	I ate.
ひどいもんだろ？	- How do you like that?
- 他に欲しいものは？	- Want anything else?
お釣りです	Your change, sir.
- どうも またどうぞ	Call again.
大丈夫ですか？	Are you hurt?
説教したけりゃ 聞いてやる	I'll listen to it.
それどころか...	Not only that.
時間の感覚が 麻痺していた	I lost all track of time.
- いいえ	- No.
いけません	No ...
後でな	Later.
女がいた	There was a woman.
- どこに行くって？	- Los Angeles.
- やっぱりな	- That's what I was afraid of.
- 今なんと？	- What did you say?
- 違う	- No.
- ううん	- No.
騙されないわよ	You're not fooling anyone.
- 一緒って... - 聞こえたはずよ	- You heard me.
もう間違いない	There was no doubt about it.
どうなの？	Well, I'm waiting.
それで？	Well?
これが人生さ	That's life.
- もっとあったはず	Not that I know of.
- 待ってくれ	- Shut up.
賞金出りゃ 突き出してやる あんたが嫌い	I don't like you.
死の香水を嗅ぐ姿は 見たくないね	- I'm not a murderer.
- それは説明を...	- Oh, skip it.
- そうだと思った	- What do you mean?
考えてもみなかった	I never thought of that.
あんたが 行方不明になると困るし	I don't want you to get lost.
どうも	Thanks.
- どうぞ 方の荷が下りる	I'm relieved.
- ああ	Yep.
- わかった	- OK.
もちろん	I invented it.
そりゃそうさ	You must be.
いらいらする	It gets on my nerves.
気にしないの	Forget it.
飲めば	Have a drink.
殺してないってことで	You didn't kill him.
どうも	Thanks.
- 君の言うとおりだ	- Maybe you're right.
- いつでもそうよ	- I'm always right.
そうよねえ	Sure is.
わかりました 教授	It's a profession.
それ考えてみな	Think of that.
俺は 考えるのに疲れた	I'm tired of thinking.
それは本当よ	I know what I'm talking about.
問題は それがいつかさ	It's only a question of when.
ああ	Yeah.
好きかって？	Like you?
愛してるさ	I love you.
もう寝るわ	I'm going to bed.
もう待てないってことだ	Shut up.
行くわよ	Come on.
毛皮のジャケット買うのさ	I want to buy it.
- 値段にもよるが	- If the price is right.
- ニューヨークですか？	- Yup.
こちらで 全て手続きしますよ	- Well ...
- さあ早く	Change your mind?
- だけど ベラ...	- Let's go.
どうも	Thank you.
新聞買ってよかった ご覧よ	Take a look at that.
- やるの - やらんからな	- Yes, you will.
- やるのよ	You think I'm crazy?
失礼します	Excuse me.
- 腹が減ってない	And I won't do it.
あんたはやるさ	I think you will.
病床だと知ったのが NYのフリしてさ	No.
- いずれにせよ私はね	Maybe. Maybe.
あんたと同じ毒を 飲ませるかも	- Yeah.
- 殺したわ - 殺してない あらそう	Alright, then.
番号案内？	Information?
わかったわ ありがとう	Thanks.
- それが何？	- So what?
- ベラ	- Vera!
- 約束するか？ わかったわよ	Alright.
- 暑くない	- Don't tell me.
ベラ！	Vera!
笑えるだろ？	Isn't that a laugh?
いいぞ！	Very well.
クリス	Chris.
おめでとう	Congratulations.
- ありがとう	- Thank you.
- どうも	- Thank you.
どうも	Thank you.
ありがたい	Thank you.
おやすみなさい	Good night.
はやく	Look.
あの女見ろよ	What do you find?
ちょっと酔ったかな	I drank too much.
- おやすみ	Good night.
- ダメ 待って	- No, wait, wait.
お巡りさん！	Agent!
お巡りさん！	Agent!
- あっち	- Over there.
- さあね	- I don't know it.
ここで待ってろ	Wait here.
君が言うなら...	We go there.
- こんばんわ タイニー	Hello, Kitty.
ジョニー見かけた？	Have you seen Johnny?
- コーヒー二つ - 気が変わったの...	Two coffees, please.
- ラム・コリンズ一つね？	Only one?
- そうそう	- Yes, yes.
乾杯 クリス	Thank you.
キティ	Kitty.
そう思う？	In short...
私 大人の人好きよ	Do you believe?
- 違うよ	- Me?
芸術家ね！	- No.
出納係かと 思ったけど...	Well...
......	Yes.
- わかった！	No, no, not.
- まだ10時2分だ	What time is it?
手紙書いていい？	Thank you.
クリストファー	Christopher.
妻が...	My wife...
ダメダメ	No.
- そうさ	- Yes.
女性を 助けようとしたんだ	It was terrible.
5年	Five years.
それと...	And...
一服どう？	Do you want one?
- 何がおかしい？	- Of you.
マジかよ	Do you see it?
ジョニー！	Johnny!
前にね	It is this way.
いいや	No.
なるほど	Yes, I understand.
わかるかい	You already know.
興味深いわ	Interesting.
- 気にしないで	- Forget it.
でも キティ...	Kitty, please.
クリス！	Chris!
- 言わなきゃいかんな	I have to tell you something.
- 何よ？	- What?
君をだました	I have deceived you.
- いくら要るの？	How much do you need?
- いや結構	No, thank you.
- ありがとう	Thank you.
酔ってるの？	Have you been drinking?
クリストファー	Christopher.
クリストファー	Christopher.
何してるの？	What are you making?
目が見えないの？	Are you blind?
- 何を？	- Which?
まあ見てれば	Of course.
- とっととやって	- Woman!
- こちらです	- Here.
- 奴か？	Is he?
まあ...	Go...
- スコッチよ	Whisky?
まあ まあ...	Go, go, go...
まあな	It could be.
クリス！	Chris!
- お客さんか	You have company.
- ジョニーって...	Johnny...
初めまして	How is it?
だが...	Yes.
かもしれませんよ	Perhaps.
幸せ？	Are you happy?
- 1000ドルも？	A thousand dollars?
どうして？	Why not?
わかってる	Yes, I know it.
- 持ってくる	- I will get it.
- さよなら	- Good-bye.
わけがわからん	I don't understand it.
私を愛してないのね	You don't love me.
- そう思うか？	No?
- うん	- No.
これでも？	And now, what?
- おやすみなさい	Good night.
- こんちわ ニック - やあ	Hello, Nick.
- どうだい？ - うーん...	Are they good?
- 大事なことか？	Is it important?
私の指輪は？	Nick.
- メトロポリタンよ	What museum?
- 何だよ？	My God.
