当地时间上午 9:30 左右 (UTC 0230)，JAS 39C 鹰狮战斗机撞上跑道并发生爆炸，导致机场关闭，商业航班无法正常起降。	The JAS 39C Gripen crashed onto a runway at around 9:30 am local time (0230 UTC) and exploded, closing the airport to commercial flights.
涉事飞行员是空军中队长迪罗里·帕塔维 (Dilokrit Pattavee)。	The pilot was identified as Squadron Leader Dilokrit Pattavee.
当地媒体报道，一辆机场消防车在响应火警时翻了车。	Local media reports an airport fire vehicle rolled over while responding.
正值上午 8 点 46 分，整座城市陷入了寂静，标示了第一架飞机撞上目标的确切时间。	At exactly 8:46 a.m. a hush fell across the city, marking the exact moment the first jet struck its target.
两束光被临时造出，彻夜指向天空。	Two beams of light have been rigged up to point skywards overnight.
该地点正在建设五座新摩天大楼，中间有一个交通中心和纪念公园。	Construction is ongoing for five new skyscrapers at the site, with a transportation center and memorial park in the middle.
美国海军还表示，他们正在调查这起事件。	The US Navy also said they were investigating the incident.
他们还在一份声明中表示，“船员目前正在确定安全撤离军舰的最佳方法”。	They also said in a statement, "The crew is currently working to determine the best method of safely extracting the ship".
这是一艘复仇者级别的反水雷舰，正在前往巴拉望的普林塞萨港的途中。	An Avenger class mine countermeasures ship, the ship was on its way to Puerto Princesa in Palawan.
它属于美国海军第七舰队，部署在日本长崎佐世保。	It is assigned to the U.S. Navy’s Seventh Fleet and based in Sasebo, Nagasaki in Japan.
“幸运的是我没有发生什么事，但我看到了可怕的一幕，人们试着打破窗户逃出去。	"Luckily nothing happened to me, but I saw a macabre scene, as people tried to break windows in order to get out.
人们用椅子敲打玻璃，但窗户却坚不可摧。	People were hitting the panes with chairs, but the windows were unbreakable.
幸存者弗朗齐歇克·科瓦尔说：“终于有一块玻璃碎了，他们开始从窗户逃出去。”	One of the panes finally broke, and they started to get out by the window," said survivor Franciszek Kowal.
事故发生后，吉布森被送往医院，但很快就一命呜呼。	After the accident occurred, Gibson was transported to a hospital but died shortly afterwards.
这位 64 岁的卡车司机在车祸中没有受伤。	The truck driver, who is aged 64, was not injured in the crash.
当天，格林尼治时间 (GMT) 约 12 时许，该车辆被拖离事故现场。	The vehicle itself was taken away from the scene of the accident at approximately 1200 GMT on the same day.
一名在事故发生地附近的车库立的工作人员说：“孩子们正等着过马路，并且都在大声尖叫，哭个不停。”	A person working in a garage near where the accident occurred said: "There were children waiting to cross the road and they were all screaming and crying."
他们都从事故发生的地方跑了回来。	They all ran back from where the accident had happened.
虽然车撞到房子时，房子里面有三个人，但最后并没有人受伤。	Although three people were inside the house when the car impacted it, none of them were hurt.
然而，司机的头部受到了重创。	However, the driver sustained serious injuries to the head.
事故发生的道路暂时封闭，紧急救援人员将司机从红色奥迪 TT 中救了出来。	The road where the crash happened was temporarily closed while emergency services freed the driver from the red Audi TT.
起初，他被送往位于大雅茅斯的詹姆斯·佩吉特医院进行救治。	He was initially hospitalised in the James Paget Hospital in Great Yarmouth.
他随后被转送到剑桥的阿登布鲁克医院。	He was subsequently relocated to Addenbrooke's Hospital in Cambridge.
