早在《每日秀》（The Daily Show）和《科尔伯特报告》（Colbert Report）之前，赫克（Heck）和约翰逊（Johnson）在 1988 年还在华盛顿大学求学时期，就曾构想过一份出版物，以嘲讽的形式戏说新闻（包括新闻报道）。	Long before The Daily Show and The Colbert Report, Heck and Johnson envisioned a publication that would parody the news—and news reporting—when they were students at UW in 1988.
自创办以来，《洋葱报》已经成为一个名副其实的讽刺戏仿类新闻帝国，旗下拥有印刷刊物、网站（10 月份吸引了 500 万独立访问者）、个人广告、24 小时新闻网络、播客，以及近期推出的名为《我们的愚蠢世界》的世界地图集。	Since its inception, The Onion has become a veritable news parody empire, with a print edition, a website that drew 5,000,000 unique visitors in the month of October, personal ads, a 24 hour news network, podcasts, and a recently launched world atlas called Our Dumb World.
艾伯特·戈尔和汤米·弗兰克斯将军漫不经心地吐露出他们最喜欢的头条（当时洋葱网曾报道说，戈尔在2000年竞选失利后，与其妻子蒂珀享受了一生中最美好的性爱时光）。	Al Gore and General Tommy Franks casually rattle off their favorite headlines (Gore's was when The Onion reported he and Tipper were having the best sex of their lives after his 2000 Electoral College defeat).
其中的许多作者后来对乔恩·斯图尔特 (Jon Stewart) 和史蒂芬·科尔伯特 (Stephen Colbert) 的新闻恶搞节目产生了巨大影响。	Many of their writers have gone on to wield great influence on Jon Stewart and Stephen Colbert's news parody shows.
这一艺术活动也是布加勒斯特市政厅发起的宣传活动的组成部分之一，旨在重新塑造罗马尼亚首都，打造出富有创意、多姿多彩的大都市形象。	The artistic event is also part of a campaign by the Bucharest City Hall that seeks to relaunch the image of the Romanian capital as a creative and colourful metropolis.
今年 6 月至 8 月，这座城市将成为东南欧第一个举办全球最大公共艺术活动奔牛节的城市。	The city will be the first in southeastern Europe to host CowParade, the world's largest public art event, between June and August this year.
这部由瑞恩·高斯林 (Ryan Gosling) 和艾玛·斯通 (Emma Stone) 主演的电影获得了各大奖项的提名。	The movie, featuring Ryan Gosling and Emma Stone, received nominations in all major categories.
高斯林和斯通分别获得了最佳男主角和最佳女主角的提名。	Gosling and Stone received nominations for Best Actor and Actress respectively.
其他提名包括最佳影片、最佳导演、最佳摄影、最佳服装设计、最佳电影剪辑、最佳原创配乐、最佳艺术指导、最佳音效剪辑、最佳混音和最佳原创剧本。	The other nominations include Best Picture, Director, Cinematography, Costume Design, Film-editing, Original Score, Production Design, Sound Editing, Sound Mixing and Original Screenplay.
该电影的两首歌曲《追梦痴子心》和《星光之城》获得了最佳原创歌曲的提名。狮门影业获得了 26 项提名，比其他任何一家工作室都要多。	Two songs from the movie, Audition (The Fools Who Dream) and City of Stars, received nominations for best original song. Lionsgate studio received 26 nominations — more than any other studio.
尽管 Winfrey 在告别时热泪盈眶，但她向粉丝们明确表示，她还会回来。	Although Winfrey was tearful in her farewell, she made it clear to her fans she will be back.
“这并不是告别。这是一个篇章的结束，也是新篇章的开始。”	"This is not going to be goodbye. This is the closing of one chapter and the opening of a new one."
”根据该电台的网站描述，这档节目是一档“带有全新震撼极客风格的老式广播剧！”	The station's web site describes the show as "old school radio theater with a new and outrageous geeky spin!"
早年，该节目仅在运营已久的互联网广播网站TogiNet Radio上播出，TogiNet Radio是一个专注于谈话广播的网站。	In its early days, the show was featured solely at the long-running internet radio site TogiNet Radio, a site focused on talk radio.
2015 年年末， TogiNet 创建了 AstroNet 广播作为子电台。	In late 2015, TogiNet established AstroNet Radio as a subsidiary station.
该节目最初由业余配音演员参演，范围从当地人到东德克萨斯州人。	The show originally featured amateur voice actors, local to East Texas.
卡米尔·圣桑 (Camille Saint-Saens) 创作的法国歌剧讲述的是一名艺术家的故事，“他一生沉迷于毒品和对日本的热爱”。	The story presented in the French opera, by Camille Saint-Saens, is of an artist "whose life is dictated by a love for drugs and Japan."
结果，演员在舞台上吸食大麻，剧院本身也鼓励观众一起加入。	As a result, the performers smoke cannabis joints on stage, and the theatre itself is encouraging the audience to join in.
这名摄影师被送往加州大学洛杉矶分校罗纳德·里根医疗中心，其后不治。	The photographer was transported to Ronald Reagan UCLA Medical Center, where he subsequently died.
报道称他年仅 20 多岁。比伯发表声明表示：“虽然我当时并不在场，也没有直接经历这起悲惨事故，但我仍为死者家属感到悲伤，为他们祈祷。”	He was reportedly aged in his 20s. In a statement, Bieber said "[w]hile I was not present nor directly involved with this tragic accident, my thoughts and prayers are with the family of the victim."
娱乐新闻网站TMZ了解到，该名摄影师在Sepulveda大道的另一侧停车，开始拍摄警察的拦截，并在横穿马路后继续拍照，促使进行交通拦截的加州公路巡警两次停下手中工作，命令他回到对面。	Entertainment news website TMZ understands the photographer stopped his vehicle on the other side of Sepulveda Boulevard and attempted to take pictures of the police stop before crossing the road and continuing, prompting the California Highway Patrol police officer conducting the traffic stop to order him back across, twice.
据警方称，撞倒摄影师的汽车司机未必会面临刑事指控。	According to police, the driver of the vehicle that hit the photographer is unlikely to face criminal charges.
在出演《辛普森一家》前，西蒙曾在几个节目中担任过多种职位。	Before The Simpsons Simon had worked on several shows in various positions.
20 世纪 80 年代，他在《出租车》、《欢呼》以及《特蕾西·厄尔曼秀》等节目工作。	During the 1980s he worked on shows such as Taxi, Cheers, and The Tracy Ullman Show.
1989 年，他与布鲁克斯和格罗宁一起创作了《辛普森一家》，并负责聘请了该剧的首支编剧团队。	In 1989 he helped create The Simpsons with Brooks and Groening, and was responsible for hiring the show's first writing team.
尽管他在 1993 年离开了节目，但他保留了执行制片人的头衔，并持续获得每季数千万美元的版税。	Despite leaving the show in 1993 he kept the title of executive producer, and continued to receive tens of millions of dollars every season in royalties.
在周四的东京电玩展上，任天堂总裁岩田聪发表主题演讲，公布了公司新一代任天堂 Revolution 游戏主机控制器的设计。	At Thursday's keynote presentation of the Tokyo Game Show, Nintendo president Satoru Iwata unveiled the controller design for the company's new Nintendo Revolution console.
该控制器类似于电视遥控器，使用放置在用户电视机附近的两个传感器来对其在三维空间中的位置进行三角测量。	Resembling a television remote, the controller uses two sensors placed near the user's television to triangulate its position in three-dimensional space.
它让玩家可以通过在空中移动设备来控制电子游戏中的运动和操作。	This will allow players to control actions and movements in video games by moving the device through the air.
根据新闻发布会的记录文字，他曾说过：”她很可爱，唱得也很好。”	"She’s very cute and sings quite well, too," he said according to a transcript of the news conference.
“每次我们排练这场表演的时候，我都很感动，打心眼里感动。”	"I was moved every time we did a rehearsal on this, from the bottom of my heart."
