赤潮的起因源于腰鞭毛藻的浓度高于正常水平。它是一种自然产生的单细胞海洋生物。	Red tide is caused by a higher than normal concentration of Karenia brevis, a naturally-occurring single-celled marine organism.
自然因素可以互相配合产生理想的条件，让这种藻类的数量急剧增加。	Natural factors can intersect to produce ideal conditions, allowing this algae to increase in number dramatically.
藻类能产生一种神经毒素，能破坏人类和鱼类的神经。	The algae produces a neurotoxin that can disable nerves in both humans and fish.
鱼类经常由于水中毒素浓度极高而死亡。	Fish often die because of the high concentrations of the toxin in the waters.
人如果吸入通过风和海浪进入空气的受污染水气，就可能受到影响。	Humans can be affected by breathing affected water taken into the air by wind and waves.
热带气旋风暴古努（以马尔代夫语中一种以棕榈叶编织的袋子命名），在最高峰时风速可达每小时 240 千米（每小时 149 英里）。	At its peak, Tropical Cyclone Gonu, named for a bag of palm leaves in the language of the Maldives, reached sustained winds of 240 kilometers an hour (149 miles per hour) .
到今天早些时候，风速为每小时 83 公里左右，预计会不断减弱。	By early today, winds were around 83 km/h, and it was expect to keep weakening.
“Luno”号上载有 120-160 立方米的燃料。在发生故障后，大风和海浪把它推到了防波堤上。	The Luno had 120–160 cubic metres of fuel aboard when it broke down and high winds and waves pushed it into the breakwater.
直升机救出了 12 名船员，其中只有一人受伤，鼻骨骨折。	Helicopters rescued the twelve crewmembers and the only injury was a broken nose.
这艘 100 米长的船是去装载常见的化肥货物的，起初官员们担心这艘船上装的货物可能会泄漏。	The 100-metre ship was en route to pick up its usual fertiliser cargo and initially officials feared the vessel could spill a load.
“到 2020 年之前，我们将努力使单位国内生产总值二氧化碳排放量比 2005 年显著下降，”胡锦涛说。	"We will endeavour to cut carbon dioxide emissions per unit of GDP by a notable margin by 2020 from the 2005 level," Hu said.
他没有设定削减数额，只是表示将根据中国的经济产出来决定数额。	He did not set a figure for the cuts, saying they will be made based on China's economic output.
胡锦涛鼓励发展中国家“不要重走先污染后治理的老路”。	Hu encouraged developing countries "to avoid the old path of polluting first and cleaning up later."
他补充道，“然而，他们不应该被要求承担超出其发展阶段、责任和能力范围的义务。”	He added that "they should not, however, be asked to take on obligations that go beyond their development stage, responsibility and capabilities."
周一晚 10：08，蒙大拿州西部发生中强地震。	A moderate earthquake shook western Montana at 10:08 p.m. on Monday.
美国地质调查局 (USGS) 及美国国家地震信息中心目前还没有收到有关地震破坏的即时报告。	No immediate reports of damage have been received by the United States Geological Survey (USGS) and its National Earthquake Information Center.
这次地震的震中位于狄龙（Dillon）东北偏北 20 公里（15英里），比尤特（Butte）以南 65 公里处（40英里）。	The earthquake was centered about 20 km (15 miles) north-northeast of Dillon, and about 65 km (40 miles) south of Butte.
表演开始五分钟后，刮起了风，约一分钟后，风速达到了 70 公里/小时……紧接着又下起了雨，雨势如此之大，像针扎一样拍打在皮肤上，随后天上下起了冰雹，惊慌失措的人群尖叫着四散奔逃。	Five minutes into the display a wind starts rolling in, about a minute later, the wind is reaching 70km/h... then the rain comes, but so hard and so large that it slaps your skin like a needle, then hail fell from the sky, people panicking and screaming and running over each other.
“我姐姐和她的朋友不见了，路上有两个残疾人坐着轮椅，有人跳过去帮他们推轮椅”，阿尔芒·范思哲说道。	I lost my sister and her friend, and on my way there were two disabled people in wheelchairs, people just jumping over and pushing them," Armand Versace said.
日本广播协会 (NHK) 还报道说，位于新泻县的柏崎刈羽 (Kashiwazaki Kariwa) 核电站运行正常。	NHK also reported that the Kashiwazaki Kariwa nuclear power plant in Niigata prefecture was operating normally.
北陆电力株式会社报道称，志贺核能发电厂 1 号和 2 号反应堆已经关闭，地震并未造成影响。	Hokuriku Electric Power Co. reported no effects from the earthquake and that the Number 1 and 2 reactors at its Shika nuclear power plant were shut down.
据报道，该地区约有 9400 户家庭断水，大约 100 户断电。	It is reported that some 9400 homes in the region are without water and approximately 100 without electricity.
一些道路受到了损坏，受影响地区的铁路服务中断，石川（Ishikawa）县的能登机场仍然处于关闭状态。	Some roads have been damaged, railway service interrupted in the affected areas, and the Noto Airport in Ishikawa prefecture remains closed.
