MySpace ocupa el tercer lugar entre los sitios web más populares usados en Estados Unidos y, en la actualidad, cuenta con 54 millones de perfiles.	MySpace is the third most popular website used in the United States and has 54 million profiles currently.
Estos sitios web han atraído mucha atención, en particular en el ámbito educativo.	These websites have gotten a lot of attention, especially in the education setting.
Existen aspectos positivos en estos sitios web, como la posibilidad de configurar de forma sencilla un salón de clases virtual que puede contener blogs, videos y fotos, entre otros.	There are positive aspects to these websites, which include, being able to easily setup a class page which can include blogs, videos, photos, and other features.
Esta página es de acceso sencillo, ya que tiene una única dirección web, lo que hace que aquellos estudiantes que pudieren tener problemas para usar el teclado o para deletrear puedan recordarla y escribirla con facilidad.	This page can easily be accessed by providing just one web address, which makes it easy to remember and easy to type in for students who may have trouble using the keyboard or with spelling.
Es posible personalizarlo para que sea de fácil lectura y, también, regular la presencia de color, según se prefiera.	It can be customized to make it easy to read and also with as much or little color as desired.
El trastorno por déficit de atención «es un síndrome neurológico en el que, por definición, convergen tres síntomas: la impulsividad, la distracción y la hiperactividad o exceso de energía».	Attention Deficit Disorder "is a neurological syndrome whose classic defining triad of symptoms including impulsivity, distractibility, and hyperactivity or excess energy".
No se trata de una discapacidad de aprendizaje, sino de un trastorno del mismo; «lo padecen entre el 3 y el 5 por ciento de los niños, posiblemente hasta 2 millones en Estados Unidos».	It is not a learning disability, it is a learning disorder; it "affects 3 to 5 percent of all children, perhaps as many as 2 million American children".
Los niños con TDA tienen dificultad para concentrarse en cosas como las tareas escolares, pero sí pueden hacerlo con actividades que les gustan, tales como jugar, mirar sus dibujos animados preferidos o escribir oraciones sin puntuación.	Children with ADD have a hard time focusing on things like school work, but they can concentrate on things they enjoy doing like playing games or watching their favorite cartoons or writing sentences without punctuation.
Estos niños tienden a meterse en montones problemas pues «adoptan comportamientos arriesgados, se involucran en peleas y desafían la autoridad» para estimular su cerebro, ya que este no puede estimularse por métodos normales.	These children tend to get into a lot of trouble, because they "engage in risky behaviors, get into fights, and challenge authority" in order to stimulate their brain, since their brain can not be stimulated by normal methods.
El TDA afecta los vínculos con otros compañeros, dado que los demás niños no logran comprender por qué actúan como lo hacen, por qué escriben del modo en que escriben o por qué no comparten el mismo nivel de madurez.	ADD affects relationships with other peers because other children can not understand why they act the way that they do or why they spell they way they do or that their maturity level is different.
Al ver esta actividad, los colonizadores también habían solicitado refuerzos.	The Colonists, seeing this activity, had also called for reinforcements.
Las tropas de refuerzo para las posiciones delanteras incluían al 1.er y al 3.er regimiento de New Hampshire, con 200 soldados, abajo el mando de los coroneles John Stark y James Reed, quienes luego ascendieron a generales.	Troops reinforcing the forward positions included the 1st and 3rd New Hampshire regiments of 200 men, under Colonels John Stark and James Reed (both later became generals).
Los hombres de Stark se desplegaron a lo largo del vallado en el extremo norte de la ubicación de los colonos.	Stark's men took positions along the fence on the north end of the Colonist's position.
Cuando la marea baja abrió una grieta junto al río Mystic a lo largo de la península noreste, velozmente prolongaron la extensión del cerco construyendo un muro bajo de piedra al norte que llegaba hasta las orillas de una pequeña playa.	When low tide opened a gap along the Mystic River along the northeast of the peninsula, they quickly extended the fence with a short stone wall to the north ending at the water's edge on a small beach.
Gridley o Stark incrustaron una estaca a unos 100 pies (30 metros) por delante de la valla y dieron la orden de que nadie abriera fuego hasta que el ejército regular la sobrepasaran.	Gridley or Stark placed a stake about 100 feet (30 m) in front of the fence and ordered that no one fire until the regulars passed it.
La base de la estrategia de EE. UU. fue el lanzamiento de ataques coordinados desde tres puntos diferentes.	The American plan relied on launching coordinated attacks from three different directions.
El general John Cadwalder iniciaría un ataque de distracción contra la tropa británica en Bordentown, con el fin de bloquear cualquier tipo de refuerzo.	General John Cadwalder would launch a diversionary attack against the British garrison at Bordentown, in order to block off any reinforcements.
El general James Ewing evitó la fuga de las tropas antagónicas tomando el puente sobre Assunpink Creek y guiando a 700 soldados a través del río en Trenton Ferry.	General James Ewing would take 700 militia across the river at Trenton Ferry, seize the bridge over the Assunpink Creek and prevent any enemy troops from escaping.
El ataque más importante, llevado a cabo por 2400 hombres, atravesaría el río nueve millas al norte de Trenton para luego dividirse en dos grupos, con el fin de lanzar un ataque antes de que saliera el sol: uno de ellos bajo el mando de Greene y, el otro, encabezado por Sullivan.	The main assault force of 2,400 men would cross the river nine miles north of Trenton, and then split into two groups, one under Greene and one under Sullivan, in order to launch a pre-dawn attack.
Aun cuando el aprendizaje basado en proyectos debería facilitar ese proceso y hacerlo más interesante, el andamiaje va un poco más allá.	While project based learning should make learning easier and more interesting, scaffolding goes a step beyond.
El andamiaje no es una técnica de aprendizaje; es, antes bien, una asistencia que proporciona apoyo a quienes atraviesan una nueva experiencia, como el uso de un nuevo programa informático o el inicio de un nuevo proyecto.	Scaffolding is not a method of learning but rather an aid that provides support to individuals whom are undergoing a new learning experience such as using a new computer program or beginning a new project.
El andamiaje puede presentarse tanto en formato real como virtual; para decirlo de otro modo, un docente es un tipo de andamio, pero también lo es el pequeño sujetapapeles animado de Microsoft Office.	Scaffolds can be both virtual and real, in other words, a teacher is a form of scaffold but so is the little paperclip man in Microsoft Office.
Los andamiajes virtuales se encuentran incorporados al software y su función es cuestionar, estimular o explicar procedimientos que pueden haber resultado complejos para el estudiante por sí solo.	Virtual Scaffolds are internalized in the software and are meant to question, prompt, and explain procedures that may have been to challenging for the student to handle alone.
Se acoge a los niños en hogares de guarda por una amplia variedad de motivos, desde negligencia hasta abuso e, incluso, extorsión.	Children are placed in Foster Care for a wide variety of reasons that range from neglect, to abuse, and even to extortion.
Ningún niño debería tener que crecer, jamás, en un entorno en el que no haya cariño, cuidados y educación; pero sucede.	No child should ever have to grow up in an environment that is not nurturing, caring, and educational, but they do.
Podemos percibir que el sistema de acogida familiar proporciona un ámbito seguro para estos niños.	We perceive the Foster Care System to be a safety zone for these children.
El objetivo de nuestro sistema de crianza de acogida es ofrecer hogares seguros, tutores amorosos, educación sostenida y asistencia médica confiable.	Our foster care system is supposed to provide safe homes, loving caregivers, stable education, and reliable health care.
El objetivo del acogimiento familiar es cubrir todas las necesidades que no eran atendidas en el hogar del que fueron recogidos con anterioridad.	Foster care is supposed to provide all the necessities that were lacking in the home they were previously taken from.
Luego de ser aprobada por el Congreso el 4 de julio, se envió un borrador escrito a mano y firmado por el presidente del Congreso, John Hancock, y el secretario, Charles Thomson, a la imprenta de John Dunlap, a unas pocas calles de distancia.	After its adoption by Congress on July 4, a handwritten draft signed by the President of Congress John Hancock and the Secretary Charles Thomson was then sent a few blocks away to the printing shop of John Dunlap.
Se realizaron, durante la noche, entre 150 y 200 copias, a las que actualmente se conoce como las «Copias Dunlap».	Through the night between 150 and 200 copies were made, now known as "Dunlap broadsides".
Fue John Nixon quien leyó por primera vez el documento y lo hizo en el patio del Salón de la Independencia, el 8 de julio.	The first public reading of the document was by John Nixon in the yard of Independence Hall on July 8.
El 6 de julio se envió una copia a George Washington, quien ordenó que se la leyeran a su ejército en Nueva York el 9 de julio. El 10 de agosto llegó otra copia a Londres.	One was sent to George Washington on July 6, who had it read to his troops in New York on July 9. A copy reached London on August 10.
Las 25 fotografías de Dunlap, que se sabe que aún existen, son las copias más antiguas conservadas del documento. El manuscrito original se ha perdido.	The 25 Dunlap broadsides still known to exist are the oldest surviving copies of the document. The original handwritten copy has not survived.
