Los patrones de pensamiento convergente son métodos para resolver problemas que relacionan distintas ideas o campos, en busca de una solución.	Convergent thinking patterns are problem solving techniques that unite different ideas or fields to find a solution.
El aspecto central de esta forma de pensar es la rapidez, la lógica y la precisión, así como la identificación de cuestiones fácticas a través de la reutilización de técnicas existentes y de la recolección de datos.	The focus of this mindset is speed, logic and accuracy, also identification of facts, reapplying existing techniques, gathering information.
Esta clase de pensamiento tiene como premisa principal la existencia de solo una respuesta correcta. Se piensa en términos de dos respuestas posibles, una correcta y otra incorrecta.	The most important factor of this mindset is: there is only one correct answer. You only think of two answers, namely right or wrong.
Este tipo de pensamiento se relaciona con ciertas ciencias o procedimientos estandarizados.	This type of thinking is associated with certain science or standard procedures.
Quienes piensan de este modo, tienen un pensamiento lógico, pueden recordar patrones, resolver problemas y trabajar en pruebas científicas.	People with this type of thinking have logical thinking, are able to memorize patterns, solve problems and work on scientific tests.
Los seres humanos son, por mucho, la especie con más talento para leer la mente de otros.	Humans are by far the most talented species in reading the minds of others.
Ello implica que tenemos la capacidad de hacer predicciones acertadas respecto de las percepciones de otras personas, lo que se proponen, sus creencias, conocimientos y deseos.	That means we are able to successfully predict what other humans perceive, intend, believe, know or desire.
Entre estas capacidades, entender la intención de los demás es crucial, ya que nos permite resolver posibles ambigüedades en las acciones físicas.	Among these abilities, understanding the intention of others is crucial. It allows us to resolve possible ambiguities of physical actions.
Por ejemplo, si usted viera a alguien romper la ventanilla de un automóvil, probablemente asumiría que intenta robar el vehículo de un tercero.	For example, if you were to see someone breaking a car window, you would probably assume he was trying to steal a stranger’s car.
Debería juzgárselo de forma diferente si hubiera extraviado las llaves de su propio automóvil y fuera este al que intentaba ingresar.	He would need to be judged differently if he had lost his car keys and it was his own car that he was trying to break into.
La IRM se basa en un fenómeno físico denominado resonancia magnética nuclear (RMN), cuyo descubrimiento tuvo lugar en la década de 1930, de la mano de Felix Bloch (que trabajaba para la Universidad de Stanford) y Edward Purcell (de la Universidad de Harvard).	MRI is based on a physics phenomenon called nuclear magnetic resonance (NMR), which was discovered in the 1930s by Felix Bloch (working at Stanford University) and Edward Purcell (from Harvard University).
Durante esta resonancia, el campo magnético y las ondas de radio causan la emisión, por parte de los átomos, de minúsculas señales de radio.	In this resonance, magnetic field and radio waves cause atoms to give off tiny radio signals.
Fue un médico e investigador científico llamado Raymond Damadian quien, en el año 1970, descubrió las bases para la utilización de la resonancia magnética por imágenes como instrumento para elaborar diagnósticos médicos.	In the year 1970, Raymond Damadian, a medical doctor and research scientist, discovered the basis for using magnetic resonance imaging as a tool for medical diagnosis.
Después de cuatro años se le otorgó una patente, la primera que se emitía a nivel mundial relacionada con la resonancia magnética.	Four years later a patent was granted, which was the world's first patent issued in the field of MRI.
En 1997, el Dr. Damadian terminó de construir el primer escáner de resonancia magnética de «cuerpo entero», al que nombró el «Indomable».	In 1977, Dr. Damadian completed the construction of the first “whole-body” MRI scanner, which he called the ”Indomitable”.
Los datos neurobiológicos ofrecen evidencia fáctica para un enfoque teórico de la investigación de la cognición. Reducen, por tanto, el campo de investigación y le confieren mayor exactitud.	Neurobiological data provide physical evidence for a theoretical approach to the investigation of cognition. Therefore it narrows the research area and makes it much more exact.
El correlato existente entre la patología cerebral y la conducta contribuye a la investigación de los científicos.	The correlation between brain pathology and behaviour supports scientists in their research.
Desde hace mucho se sabe que varios tipos de daño cerebral, traumas, lesiones y tumores afectan la conducta y causan cambios en las funciones mentales.	It has been known for a long time that different types of brain damage, traumas, lesions, and tumours affect behaviour and cause changes in some mental functions.
Gracias al apogeo de las nuevas tecnologías, tenemos la posibilidad de ver e investigar estructuras y procesos que se producen en el cerebro que jamás antes se han visto.	The rise of new technologies allows us to see and investigate brain structures and processes never seen before.
Esto nos proporciona abundante información y material para desarrollar modelos de simulación, que favorecen nuestra comprensión acerca de los procesos mentales.	This provides us with a lot of information and material to build simulation models which help us to understand processes in our mind.
Si bien se asocia mucho la inteligencia artificial con la ciencia ficción, es una especialidad de gran relevancia dentro de la informática, que se encarga del comportamiento, el aprendizaje y la adaptación inteligente en una máquina.	Although AI has a strong connotation of science fiction, AI forms a very important branch of computer science, dealing with behavior, learning and intelligent adaptation in a machine.
La investigación en el campo de la IA supone el desarrollo de máquinas a fin de automatizar tareas que requieren un comportamiento inteligente.	Research in AI involves making machines to automate tasks that require intelligent behavior.
Ejemplos de ello son, entre otros, el monitoreo, planificación y programación, la capacidad para responder diagnósticos y consultas de los clientes, así como el reconocimiento facial, de escritura, de voz.	Examples include control, planning and scheduling, the ability to answer customer diagnoses and questions, as well as handwriting recognition, voice and face.
Estas cuestiones se han vuelto disciplinas separadas, enfocadas en ofrecer soluciones a problemas de la vida real.	Such things have become separate disciplines, which focus on providing solutions to real life problems.
El sistema de Inteligencia Artificial se utiliza ahora a menudo en los sectores de la economía, la medicina, la ingeniería y la milicia, del mismo modo en que fue incorporado en diversas aplicaciones de software de videojuegos y computadoras personales.	The AI ​​system is now often used in the fields of economics, medicine, engineering and the military, as has been built in several home computer and video game software applications.
