La expresión genérica «Papeles de Panamá» se refiere a los casi diez millones de documentos del despacho de abogados panameño Mossack Fonseca que se filtraron en los medios en la primavera de 2016.	"Panama Papers" is an umbrella term for roughly ten million documents from Panamanian law firm Mossack Fonseca, leaked to the press in spring 2016.
La documentación reveló que catorce entidades bancarias ayudaron a clientes acaudalados a ocultar riquezas que ascendían a miles de millones de dólares estadounidenses con el fin de evadir obligaciones impositivas y otras regulaciones.	The documents showed fourteen banks helped wealthy clients hide billions of US dollars of wealth to avoid taxes and other regulations.
El periódico británico The Guardian señaló que Deutsche Bank tenía el control de cerca de la tercera parte de las 1200 compañías fantasma que se usaron para llevar esto a cabo.	British newspaper The Guardian suggested Deutsche Bank controlled roughly a third of the 1200 shell companies used to accomplish this.
Se llevaron a cabo manifestaciones a nivel mundial, se condujeron numerosos juicios criminales, y los jefes de estado tanto de Islandia como de Pakistán renunciaron.	There were protests worldwide, several criminal prosecutions, and the leaders of the governments of Iceland and Pakistan both resigned.
La prisión de Abu Ghraib en Irak se incendió durante un motín.	Iraq's Abu Ghraib prison has been set alight during a riot.
La cárcel se hizo conocida después de que salieran a la luz los abusos de prisioneros, luego de que las fuerzas norteamericanas asumieran el mando.	The jail became notorious after prisoner abuse was discovered there after US forces took over.
Durante el Gran Premio de Singapur de 2008, justo después de una parada en boxes, Piquet Jr. se estrelló para forzar la salida del auto de seguridad y así beneficiar a Fernando Alonso.	Piquet Jr. crashed in the 2008 Singapore Grand Prix just after an early pit stop for Fernando Alonso, bringing out the safety car.
Cuando los automóviles delante de Alonso se detuvieron para recargar combustible durante la pasada del coche de seguridad, él aumentó los cambios para obtener la victoria.	As the cars ahead of Alonso went in for fuel under the safety car, he moved up the pack to take victory.
Luego del GP de Hungría en el año 2009, expulsaron a Piquet Jr.	Piquet Jr. was sacked after the 2009 Hungarian Grand Prix.
En los últimos tres meses, se liberaron más de 80 detenidos de la Reserva Central sin una acusación formal.	In the last 3 months, over 80 arrestees were released from the Central Booking facility without being formally charged.
En abril de este año, el juez Glynn firmó una orden de protección contra la prisión para obligarla efectivizar la liberación de quienes fueran detenidos por más de 24 horas desde su ingreso sin que un comisionado de la corte los oyera en una audiencia.	In April this year, a temporary restaining order was issued by Judge Glynn against the facility to enforce the release of those held more than 24 hours after their intake who did not receive a hearing by a court commissioner.
El comisionado fija el monto de la fianza, si se la aprueba, y formaliza los cargos presentados por el oficial que procedió a su detención. Los mismos se ingresan, a continuación, en el sistema informático del estado, a través del cual se hace el seguimiento del caso.	The commissioner sets bail, if granted, and formalizes the charges filed by the arresting officer. The charges are then entered into the state's computer system where the case is tracked.
En la audiencia también se fija la fecha en la que el sospechoso podrá ejercer su derecho de solicitar un juicio rápido.	The hearing also marks the date for the suspect’s right to a speedy trial.
Según Ansa, «la policía estaba preocupada por unos asaltos de máximo riesgo que temían pudieran desencadenar en verdadera una secuencia de guerra.	According to Ansa, "police were concerned by a couple of top-level hits they feared might spark a full-blown war of succession.
La policía expresó que Lo Piccolo corría con ventaja, ya que había sido el hombre de confianza de Provenzano en Palermo y su gran experiencia le permitió ganar el respeto de la generación previa de jefes ya que éstos seguían la política de Provenzano de mantener un perfil tan bajo como fuera posible mientras que fortalecían su red de poder.	Police said Lo Piccolo had the upper hand because he had been Provenzano's right-hand man in Palermo and his greater experience won him the respect of the older generation of bosses as they pursued Provenzano's policy of keeping as low as possible while strengthening their power network.
Provenzano ya había controlado a estos jefes para cuando terminó con la guerra promovida por Riina contra el estado, la que tuvo como saldo la muerte, en 1922, de Giovanni Falcone y Paolo Borsellino, dos luchadores en contra la mafia».	These bosses had been reined in by Provenzano when he put an end to the Riina-driven war against the state that claimed the lives of Mafia crusaders Giovanni Falcone and Paolo Borsellino in 1992."
Brasil es el país católico romano más grande del mundo y la iglesia católica romana se ha opuesto siempre a la legalización del matrimonio igualitario en ese país.	Brazil is the largest Roman Catholic country on Earth, and the Roman Catholic Church has consistently opposed the legalization of same-sex marriage in the country.
El congreso nacional de Brasil ha debatido su legalización por 10 años y, en la actualidad, estos matrimonios civiles están permitidos únicamente en Rio Grande do Sul.	The National Congress of Brazil has debated legalization for 10 years, and such civil marriages are currently only legal in Rio Grande do Sul.
La exalcaldesa de San Pablo, Marta Suplicy, fue la redactora del primer proyecto de ley, el que, actualmente, y luego de sufrir algunas modificaciones, se encuentra en poder de Roberto Jefferson.	The original bill was drafted by former mayor of São Paulo, Marta Suplicy. The proposed legislation, after being amended, is now in the hands of Roberto Jefferson.
Los manifestantes esperan poder llegar a juntar alrededor de 1,2 millones de firmas para presentar en el Congreso en noviembre.	Protesters hope to collect a petition of 1.2 million signatures to present to the National Congress in November.
Luego de que cobró notoriedad el hecho de que numerosas familias recurrieron a asesoramiento legal contra los desalojos, el 20 de marzo se realizó una reunión en el Centro Legal de la Comunidad de East Bay con las víctimas de la estafa en torno a las viviendas.	After it became apparent that many families were seeking legal help to fight the evictions, a meeting was held on March 20 at the East Bay Community Law Center for the victims of the housing scam.
Cuando los inquilinos comenzaron a contarse lo que les había pasado, las familias afectadas de pronto se dieron cuenta de que Carolyn Wilson, de la OHA, había tomado los depósitos de seguridad y huido de la ciudad.	When the tenants started sharing what had occurred to them, most of the families involved suddenly realized that Carolyn Wilson of the OHA had stolen their security deposits, and skipped out of town.
Los inquilinos de Lockwood Gardens estiman que podría haber otras 40 familias, o quizás más, que enfrentan el desalojo, dado que tomaron conocimiento de que la fuerza policial de la OHA conduce también una investigación en otras propiedades de vivienda pública en Oakland, que podrían estar afectadas por estafas habitacionales.	Tenants at Lockwood Gardens believe that there may be another 40 families or more to face eviction, since they learned that OHA police are also investigating other public housing properties in Oakland that may be caught up in the housing scam.
El grupo canceló la función en el War Memorial Stadium de Maui, al que asistirían 9000 personas, y ofreció una disculpa a sus seguidores.	The band canceled the show at Maui's War Memorial Stadium, which was set to be attended by 9,000 people, and apologized to fans.
El día de la cancelación; esto es, el 20 de septiembre, la empresa que administra la banda, HK Management Inc., no indicó los motivos iniciales que la provocaron, mas, al día siguiente, atribuyó lo sucedido a cuestiones de tipo logísticas.	The band's management company, HK Management Inc., gave no initial reason when they canceled on September 20, but blamed logistical reasons by the next day.
Luego de haber sido encontrados culpables de los cargos de soborno y corrupción, los reconocidos abogados de Grecia, Sakis Kechagioglou y George Nikolakopoulos, fueron encarcelados en la prisión de Korydallus, en Atenas.	The famous Greek lawyers, Sakis Kechagioglou and George Nikolakopoulos have been imprisoned in the Athens' jail of Korydallus, as they were found guilty of graft and corruption.
Como resultado, se ha desatado un gran escándalo en la comunidad jurídica griega, derivado de la exposición de conductas ilegales que jueces, abogados, procuradores y representantes legales han llevado a cabo durante los últimos años.	As a result of this, a big scandal within the Greek legal community has been raised through the exposure of illegal actions that judges, lawyers, solicitors and attorneys have done during the previous years.
Unas semanas atrás, luego de la publicación hecha por el periodista Makis Triantafylopoulos en su famoso programa televisivo Zoungla, en Alpha TV, el congresista y abogado Petros Mantouvalos presentó su renuncia, debido a que miembros de su oficina quedaron implicados en casos de sobornos y corrupción.	A few weeks ago, after the information published by the journalist Makis Triantafylopoulos in his popular Television show "Zoungla" in Alpha TV, the member of Parliament and lawyer, Petros Mantouvalos was abdicated as members of his office had been involved in illegal graft and corruption.
Por otra parte, el alto magistrado, Evangelos Kalousis, se encuentra en prisión por haber sido encontrado culpable de corrupción y comportamiento degenerado.	Moreover, top judge Evangelos Kalousis is imprisoned as he found guilty of corruption and degenerate behaviour.
Hoy, mientras se llevaban a cabo los funerales de Jeff Weise y de tres de las nueve víctimas, se difundió la noticia en la comunidad de Red Lake de que se arrestó a otro estudiante en relación a los tiroteos en la escuela el 21 de marzo.	News spread in the Red Lake community today as funerals for Jeff Weise and three of the nine victims were held that another student was arrested in connection with the school shootings of March 21.
Las autoridades hicieron pocas declaraciones oficiales aparte de confirmar el arresto de hoy.	Authorities said little officially beyond confirming today's arrest.
No obstante, una fuente cercana a la investigación comentó al Minneapolis Star-Tribune que era Louis Jordain, de 16 años, hijo de Floyd Jourdain, presidente de la tribu Red Lake.	However, a source with knowledge of the investigation told the Minneapolis Star-Tribune that it was Louis Jourdain, 16-year old son of Red Lake Tribal Chairman Floyd Jourdain.
Por el momento, no se sabe qué cargos se imputarán o qué condujo a las autoridades hasta el niño, pero se ha dado inicio a procedimientos penales de menores en el tribunal federal.	It is not known at this time what charges will be laid or what led authorities to the boy but juvenile proceedings have begun in federal court.
Christopher García, el portavoz del Departamento de Policía de Los Ángeles, dijo que están investigando al hombre sospechoso por invasión a la propiedad privada y no por vandalismo.	Christopher Garcia, a spokesperson of the Los Angeles Police Department, said the suspected male offender is being investigated for trespassing rather than vandalism.
El cartel no tuvo daños materiales, ya que la modificación se logró con el uso de lonas negras decoradas con signos de paz y corazones para transformar las «O» de modo tal que se vieran como «e» minúsculas.	The sign was not physically damaged; the modification was done using black tarpaulins decorated with signs of peace and heart to alter the "O" to read lowercase "e".
El juicio tuvo lugar en la Corte de la Corona de Birmingham y finalizó el 3 de agosto.	The trial took place at Birmingham Crown Court and concluded on August 3.
El presentador, a quien se arrestó en el lugar, negó la agresión y sostuvo que empleó el palo como protección contra las botellas que hasta unas treinta personas le lanzaban.	The presenter, who was arrested at the scene, denied the attack and claimed he used the pole to protect himself from bottles being thrown at him by up to thirty people.
Se condenó a Blake por intento de obstrucción de justicia.	Blake was also convicted of attempting to pervert the course of justice.
El juez le manifestó a Blake que era «prácticamente inevitable» que lo enviaran a prisión.	The judge told Blake it was "almost inevitable" he was going to be sent to jail.
Se cree que el hombre guio un vehículo de tres ruedas munido con explosivos hacia la multitud.	The man allegedly drove a three-wheeled vehicle armed with explosives into a crowd.
Se detuvo al sospechoso de detonar la bomba luego de que sufriera heridas debido a la explosión.	The man suspected of detonating the bomb was detained, after sustaining injuries from the blast.
Su nombre es aún desconocido para las autoridades, aunque saben que es miembro del grupo étnico iugur.	His name is still unknown to authorities, although they do know he is a member of the Uighur ethnic group.
El 1 de enero comenzaron los problemas, cuando docenas de lugareños presentaron quejas en la oficina de correo de Obanazawa por no haber recibido sus tarjetas tradicionales y usuales de Año Nuevo.	The issue started on January 1st when dozens of local residents started complaining to the Obanazawa Post Office that they hadn't received their traditional and regular New Year cards.
Ayer, el servicio postal pidió disculpas públicas a los ciudadanos y a la prensa, después de haber tomado conocimiento de que había sido un niño quien había ocultado más de 600 piezas postales, que incluían 429 saludos de Año Nuevo, que no llegaron a sus destinatarios.	Yesterday, the post office released their apology to citizens and the media after discovering that the boy had hidden more than 600 postal documents, including 429 New Year postcards, which weren't delivered to their intended recipients.
«Gracias por los que apoyaron a un convicto como yo», dijo Siriporn en una conferencia de prensa, según se lo citó.	"Thanks for those who supported a convict like me," Siriporn was quoted as saying at a press conference.
Algunos puede que no estén de acuerdo, pero me da igual.	"Some may not agree but I don't care.
Me causa felicidad que haya personas dispuestas a brindarme su apoyo.	I am happy that there are people willing to support me.
Ella afirmó: «No hay inteligencia que sugiera que sea esperable un ataque en lo inmediato.	She said, "There is no intelligence to suggest that an attack is expected imminently.
No obstante, el hecho de que haya disminuido el nivel de amenaza a severo no implica que se haya disipado el peligro general».	However, the reduction of the threat level to severe does not mean the overall threat has gone away."
Aunque las autoridades no están seguras de que la amenaza sea real, la Autoridad de Transporte de Maryland procedió al cierre, a requerimiento del FBI.	While authorities are unsure of the credibility of the threat, the Maryland Transportaion Authority made the closure with the urging of the FBI.
Se bloquearon los accesos a los túneles con camiones volquete y fue necesaria la participación de 80 agentes de policía para guiar a los automovilistas hacia los desvíos.	Dump trucks were used to block tube entrances and assistance of 80 police were on hand to direct motorists to detours.
La circunvalación, que es la carretera alternativa de la ciudad, no registró mayores demoras por tráfico.	There were no heavy traffic delays reported on the beltway, the city's alternate route.
El proceso legal fue llevado a cabo en Virginia, ya que allí se encuentra la sede de la compañía más importante de servicios de Internet, AOL, que fue quien presentó los cargos.	The case was prosecuted in Virginia because it is the home to the leading internet service provider AOL, the company who instigated the charges.
Esta es la primera vez que se obtiene una condena basada en la legislación sancionada en 2003 para detener los correos electrónicos masivos, conocidos como spam, provenientes de la distribución no solicitada en las casillas de correo de los usuarios.	This is the first time a conviction has been gained using the legislation enacted in 2003 to curb bulk e-mail, aka spam, from unsolicited distribution into users mailboxes.
El movimiento Liberación Animal y la Real Sociedad para la Prevención de la Crueldad contra los Animales (RSPCA) nuevamente reclaman la instalación obligatoria de cámaras de videovigilancia en todos los mataderos de Australia.	Animal Liberation and the Royal Society for the Prevention of Cruelty to Animals (RSPCA) are again calling for the mandatory installation of CCTV cameras in all Australian abattoirs.
David, O'Shannessy, jefe de inspección de la RSPCA Nueva Gales del Sur, afirmó a ABC que en Australia debería ser algo normal someter a vigilancia e inspecciones a los mataderos.	RSPCA New South Wales chief inspector David O'Shannessy told the ABC that surveillance and inspections of abattoirs should be commonplace in Australia.
«Al instalar un circuito cerrado de televisión, de seguro se estará enviando un mensaje contundente a aquellos que trabajan con animales de que su bienestar es de prioridad capital».	"The CCTV would certainly send a strong signal to those people working with animals that their welfare is of the highest priority."
Karno es un reconocido, aunque controvertido profesor de inglés que enseñó en Modern Education y en King's Glory y que aseguró haber tenido 9000 estudiantes en el pico de su carrera.	Karno is a well-known but controversial English tutor who taught under Modern Education and King's Glory who claimed to have 9,000 students at the peak of his career.
En las notas utilizaba palabras que algunos padres creían que eran groseras y, de acuerdo a los informes, utilizó además malas palabras durante la clase.	In his notes he used words which some parents considered coarse, and he reportedly used profanity in class.
Modern Education lo acusó de publicar grandes anuncios publicitarios en los autobuses sin ser autorizado y de mentir al decir que era el instructor principal de inglés.	Modern Education accused him of printing large advertisements on buses without authorisation and lying by saying that he was the chief English tutor.
También se lo acusó en el pasado de violar derechos de autor, pero no se levantaron cargos en su contra.	He has also been accused previously of copyright infringement, but was not charged.
Un ex estudiante relató que el hombre «utilizaba lenguaje lunfardo en las clases, enseñaba habilidades para usar durante las citas en notas y actuaba como si fuera un amigo de los alumnos».	A former student said that he 'used slang in class, taught dating skills in notes, and was just like the students' friend.'
Los historiadores critican las políticas pasadas del FBI por concentrar sus recursos en casos de fácil resolución, en especial los de automóviles robados, con la intención de mejorar su tasa de éxito.	Historians have criticized past FBI policies for focusing resources on cases which are easy to solve, especially stolen car cases, with the intent of boosting the agency's success rate.
En el año fiscal 2005, el Congreso inició la financiación de la campaña contra la obscenidad y dio la instrucción de que el FBI debe asignar 10 agentes a ocuparse de la pornografía para adultos.	Congress began funding the obscenity initiative in fiscal 2005 and specified that the FBI must devote 10 agents to adult pornography.
Las autoridades de Ohio informaron que se acusará de homicidio agravado a un médico que trabajó en el hospital para niños de Pittsburgh, Pensilvania, después de que se encontrara el cadáver de su madre en el maletero de su auto el día miércoles.	A doctor who worked at Children's Hospital of Pittsburgh, Pennsylvania will be charged with aggravated murder after her mother was found dead in the trunk of her car Wednesday, authorities in Ohio say.
La doctora Malar Balasubramanian, de 29 años, fue hallada en Blue Ash, Ohio, un suburbio ubicado a unas 15 millas al norte de Cincinnati, recostada sobre el suelo al lado de la carretera, vistiendo una remera y ropa interior, y en aparente estado de a sobremedicación.	Dr. Malar Balasubramanian, 29, was found in Blue Ash, Ohio, a suburb approximately 15 miles north of Cincinnati lying on the ground beside the road in a T-shirt and underwear in an apparently heavily medicated state.
Guio a los oficiales hasta su Oldsmobile Intrigue negro, que se encontraba a 500 pies del lugar.	She directed officers to her black Oldsmobile Intrigue which was 500 feet away.
Allí descubrieron el cadáver de Saroja Balasubramanian, de 53 años, tapado con mantas teñidas con sangre.	There, they found the body of Saroja Balasubramanian, 53, covered with blood-stained blankets.
La policía manifestó que el cadáver parecía haber estado allí alrededor de un día.	Police said that the body appeared to have been there for about a day.
Una vez que cesaron los enfrentamientos, luego de que se trasladaran al hospital a los heridos, cerca de 40 de los prisioneros restantes permanecieron en el patio, resistiéndose a ir a sus celdas.	When the fighting ceased after the wounded were transported to the hospital, about 40 of the other remaining inmates stayed in the yard and refused to return to their cells.
Aunque los negociadores intentaron componer la situación, las exigencias de los presos son confusas.	Negotiators tried to rectify the situation, but the prisoners' demands are not clear.
Los internos desataron un incendio en el patio de la prisión entre las 10:00 y 11:00 p. m. MDT.	Between 10:00-11:00 pm MDT, a fire was started by the inmates in the yard.
Rápidamente, agentes munidos con equipos antidisturbios ingresaron al patio y abatieron a los presidiarios con gases lacrimógenos.	Soon, officers equipped with riot gear entered the yard and cornered the inmates with tear gas.
Los equipos de rescate antincendios lograron extinguir el fuego a las 11:35 p. m.	Fire rescue crews eventually doused the fire by 11:35 pm.
Se informó que los saqueos generalizados se extendieron toda la noche, dado que no hubo presencia policial en las calles de Bishkek.	Widespread looting reportedly continued overnight, as law enforcement officers were not present on Bishkek's streets.
Un observador describió a Bishkek como si se hundiera en un estado de «anarquía» mientras grupos de personas vagaban por las calles y saqueaban las tiendas de venta de bienes de consumo.	Bishkek was described as sinking into a state of "anarchy" by one observer, as gangs of people roamed the streets and plundered stores of consumer goods.
Varios habitantes de Biskek culparon a los manifestantes del sur por el desenfreno.	Several Bishkek residents blamed protesters from the south for the lawlessness.
Con anterioridad, la agencia de noticias de China, Xinhua, había comunicado el secuestro de un avión.	Earlier the Chinese news agency Xinhua reported a plane to be hijacked.
Según informes subsiguientes, la aeronave recibió una amenaza de bomba y se la desvió de vuelta hacia Afganistán, donde aterrizó en Kandahar.	Later reports then stated the plane received a bomb threat and was diverted back to Afghanistan, landing in Kandahar.
Los informes preliminares indican que la aeronave fue desviada de vuelta a Afganistán luego de negarle autorización para realizar un aterrizaje de emergencia en Urumchi.	The early reports say the plane was diverted back to Afghanistan after being denied an emergency landing in Ürümqi.
Una bomba fue detonada en la puerta de la oficina del gobernador general.	One bomb exploded outside the governor general's office.
Otras tres bombas fueron detonadas en las inmediaciones de establecimientos gubernamentales en un tramo de dos horas.	Three more bombs exploded near government buildings in a period of two hours.
Si bien existen informes que señalan que el número oficial de muertos es ocho y las autoridades han confirmado que cerca de 30 personas resultaron herida, aún se desconocen las cifras oficiales.	Some reports put the official death toll at eight, and official reports confirm that up to 30 were injured; but final numbers are not yet known.
Se encontraron concentraciones de ácido cianúrico y melamina en las muestras de orina analizadas de animales que murieron tras ingerir comida para mascotas contaminada.	Both cyanuric acid and melamine were found in urine samples from pets that died after consuming contaminated pet food.
Los investigadores indicaron que los dos compuestos reaccionan entre sí para dar lugar a cristales que pueden obstruir la función renal.	The two compounds react with one another to form crystals that may block kidney function, researchers at the university said.
Los especialistas detectaron la formación de cristales en el orín de los felinos, por la incorporación de melamina y ácido cianúrico.	The researchers observed crystals formed in cat urine by the addition of melamine and cyanuric acid.
Al ser comparados a través del uso de la espectroscopia infrarroja (FTIR), pudo determinarse que la composición de los cristales coincide con la encontrada en la orina de las mascotas afectadas.	The composition of these crystals matches those found in the urine of affected pets when compared by infrared spectroscopy (FTIR).
Nicholas Alden y Zachary Cuddeback, de 25 y 21 años, respectivamente, fallecieron. Este último iba al volante.	The fatalities were Nicholas Alden, 25, and Zachary Cuddeback, 21. Cuddeback had been the driver.
Edgar Veguilla sufrió heridas en el brazo y en la mandíbula, mientras que para Kristoffer Schneider fue necesaria una cirugía de reconstrucción facial.	Edgar Veguilla received arm and jaw wounds while Kristoffer Schneider was left requiring reconstructive surgery for his face.
El arma de Uka se atascó mientras apuntaba hacia la cabeza de un quinto hombre. Schneider sufre dolor permanente, no ve con uno de sus ojos, le falta una parte del cráneo y su rostro debió ser reconstruido con titanio.	Uka's weapon failed whilst pointed at a fifth man's head. Schneider has ongoing pain, blindness in one eye, a missing section of skull and a face rebuilt from titanium.
Schneider prestó testimonio a través de un enlace virtual desde una base de la Fuerza Aérea de los Estados Unidos en su país de origen.	Schneider testified via videolink from a USAF base in his homeland.
La fuerza policial de Madhya Pradesh pudo recuperar el ordenador portátil y el teléfono celular sustraídos.	The Madhya Pradesh Police recovered the stolen laptop and mobile phone.
El inspector general adjunto, D.K. Arya, declaró: «Hemos puesto bajo arresto a cinco individuos que abusaron de la mujer suiza y recuperamos su teléfono móvil y su computadora portátil».	Deputy Inspector General D K Arya said, "We have arrested five persons who raped the Swiss woman and recovered her mobile and laptop".
Baba, Bhutha, Rampro, Gaza y Vishnu Kanjar son los imputados.	The accused are named as Baba Kanjar, Bhutha Kanjar, Rampro Kanjar, Gaza Kanjar and Vishnu Kanjar.
Según manifestara el superintendente de la policía, Chandra Shekhar Solanki, los acusados se presentaron ante el tribunal con sus rostros cubiertos.	Police superintendent Chandra Shekhar Solanki said the accused appeared in court with covered faces.
Desde entonces, Adekoya ha estado en el Tribunal del condado de Edimburgo, acusada del asesinato de su hijo.	Adekoya has since been in Edinburgh Sheriff Court charged with murdering her son.
Si bien ella se encuentra bajo custodia a la espera de la acusación y el juicio, cualquier declaración de un testigo ocular puede ser cuestionable, ya que su imagen ha sido objeto de una amplia difusión.	She is in custody pending indictment and trial, but any eyewitness evidence may be tainted because her image has been widely published.
Es una práctica común en otras regiones del Reino Unido, pero como la justicia escocesa funciona de otro modo, los tribunales consideraron la publicación de fotografías como algo potencialmente perjudicial.	This is common practice elsewhere in the UK but Scottish justice works differently and courts have viewed publication of photos as potentially prejudicial.
La profesora Pamela Ferguson de la Universidad de Dundee señaló: «al parecer, los periodistas caminan sobre terreno peligroso cuando publican fotos u otra información de los sospechosos».	Professor Pamela Ferguson of the University of Dundee notes "journalists do seem to be walking a dangerous line if publishing photos etc of suspects."
La Oficina de la Corona, que tiene a su cargo los procesamientos, señaló a los periodistas que no se harían comentarios adicionales al menos hasta que se dicte el auto de procesamiento.	Crown Office, which is in overall charge of prosecutions, has indicated to journalists that no further comment will be made at least until indictment.
En Manila, capital de Filipinas, un ex agente policial de ese país secuestró un autobús y mantuvo cautivos a turistas que venían de Hong Kong.	A former Filipino policeman has kept Hong Kong tourists hostage by hijacking their bus in Manila, the capital of the Philippines.
Rolando Mendoza abrió fuego con su M16 contra los visitantes extranjeros.	Rolando Mendoza fired his M16 rifle at the tourists.
Se han rescatado varios rehenes y, hasta ahora, se ha confirmado que al menos seis han muerto.	Several hostages have been rescued and least six have been confirmed dead so far.
Tanto los seis rehenes, entre los que había niños y ancianos, como los fotógrafos filipinos, fueron puestos en libertad temprano.	Six hostages, including the children and elderly, were released early, as were the Filipino photographers.
Más tarde, los fotógrafos ocuparon el lugar de una anciana porque necesitaba ir al baño. Mendoza fue acribillado.	The photographers later took the place of an aged lady as she needed the lavatory. Mendoza was gunned down.
