El 24 de septiembre de 1759, Arthur Guinness suscribió un contrato de arrendamiento de 9000 años de vigencia por la cervecería St. James's Gate en Dublín, Irlanda.	On September 24, 1759, Arthur Guinness signed a 9,000 year lease for the St James' Gate Brewery in Dublin, Ireland.
Un cuarto de milenio más tarde, Guinness se ha vuelto un negocio a nivel mundial que origina más de 10 mil millones de euros (14,7 mil millones de dólares) anualmente.	250 years later, Guinness has grown to a global business that turns over 10 billion euros (US$14.7 billion) every year.
La distribuidora de videojuegos Konami manifestó hoy en un periódico de Japón que Six days en Fallujah no será sacado al mercado.	The game publisher Konami stated today in a Japanese newspaper that they will not be releasing the game Six Days in Fallujah.
El juego se basa en la Segunda Batalla de Faluya, un enfrentamiento despiadado entre el ejército norteamericano y el iraquí.	The game is based on the Second Battle of Fallujah, a vicious battle between American and Iraqi forces.
Los pasajeros pudieron beber agua mientras esperaban a una temperatura de 90 °F.	Passengers were given water as they waited in 90(F)-degree heat.
Scott Kouns, capitán del cuartel de bomberos, comentó: «Era un día de calor en Santa Clara, con temperaturas de 90 grados.	Fire captain Scott Kouns said, "It was a hot day in the Santa Clara with temperatures in the 90s.
Sea cual sea el tiempo que podría pasarse atrapado en una montaña rusa, resultaría incómodo, como mínimo, y llevó al menos una hora lograr descender a la primera persona del juego».	Any length of time trapped on a roller coaster would be uncomfortable, to say the least, and it took at least an hour to get the first person off the ride."
En 1956, Słania se trasladó a Suecia, donde, después de tres años, consiguió un empleo en la oficina postal sueca y allí se convirtió en Chief engraver.	In 1956 Słania moved to Sweden, where three years later he began work for the Swedish Post Office and became their chief engraver.
La cantidad de sellos que confeccionó, tanto para Suecia como para otras 28 naciones, supera las mil unidades.	He produced over 1,000 stamps for Sweden and 28 other countries.
La calidad y el nivel de detalle de su labor son tan reconocidos que se ha vuelto uno de los pocos «nombres familiares» entre los filatelistas. Hay personas que se especializan en recopilar su obra.	His work is of such recognized quality and detail that he is one of the very few "household names" among philatelists. Some specialize in collecting his work alone.
Incluido en el libro Guinness de los récords mundiales, su milésimo sello fue el formidable «Hazañas memorables de los reyes suecos» (David Klöcker Ehrenstrahl, año 2000).	His 1,000th stamp was the magnificent "Great Deeds by Swedish Kings" by David Klöcker Ehrenstrahl in 2000, which is listed in the Guinness Book of World Records.
Además, tuvo participación en al grabado de billetes para muchos estados, siendo los ejemplos más recientes de su labor los retratos del primer ministro visibles en el anverso de los nuevos billetes de 5 y 100 dólares canadienses.	He was also engaged in engraving banknotes for many countries, recent examples of his work including the Prime Ministerial portraits on the front of the new Canadian $5 and $100 bills.
Aerosmith canceló los conciertos pendientes de su gira.	Aerosmith have cancelled their remaining concerts on their tour.
La banda de rock tenía programado un tour por EE. UU. y Canadá que terminaría el 16 de septiembre.	The rock band was due to tour the United States and Canada until September 16.
El motivo de la cancelación de la gira fue la lesión que sufrió el vocalista Steven Tyler al caer del escenario durante una de sus presentaciones el 5 de agosto.	They have cancelled the tour after lead singer Steven Tyler was injured after he fell off stage while performing on August 5.
El inicio del programa tuvo lugar a las 8:30 p. m. hora local (15:00 UTC).	The program started at 8:30 p.m. local time (15.00 UTC).
Reconocidos cantantes nacionales interpretaron bhajans, o canciones de devoción, a los pies del Shri Shyam.	Famous singers across the country presented bhajans, or devotional songs, to Shri Shyam's feet.
El cantante Sanju Sharma fue quien inauguró el evento y le siguió Jai Shankar Choudhary. También interpretó el chhappan bhog bhajan, junto al cantante Raju Khandelwal.	Singer Sanju Sharma started the evening, followed by Jai Shankar Choudhary. esented the chhappan bhog bhajan as well. Singer, Raju Khandelwal was accompanying him.
Después de eso, Lakkha Singh pasó al frente para cantar los bhajans.	Then, Lakkha Singh took the lead in singing the bhajans.
Baba Shyam fue honrado con 108 platos de Chhappan Bhog que, en la religión hindú, consiste en 56 piezas comestibles distintas, como dulces, frutas, nueces, platos, entre otros, que se sirven como ofrenda al dios.	108 plates of Chhappan Bhog (in Hinduism, 56 different edible items, like, sweets, fruits, nuts, dishes etc. which are offered to deity) were served to Baba Shyam.
Además, Lakkha Singh interpretó el chhappan bhog bhajan junto al cantante Raju Khandekwak.	Lakkha Singh presented the chhappan bhog bhajan as well. Singer, Raju Khandelwal was accompanying him.
