El autobús iba al Six Flags St. Louis, Misuri, para que la banda tocara frente a una multitud que había agotado los boletos.	The bus was headed to Six Flags St. Louis in Missouri for the band to play to a sold-out crowd.
Conforme relataron los testigos, a la 1:15 de la madrugada del sábado, mientras el autobús cruzaba un semáforo en verde, el vehículo hizo un giro en frente de él.	At 1:15 a.m. Saturday, according to witnesses, the bus was going through a green light when the car made a turn in front of it.
La noche del 9 de agosto, el ojo de Morakot quedó a cerca de 60 km de distancia de la ciudad china de Fujian.	As of the night of August 9, the eye of Morakot was about seventy kilometres away from the Chinese province of Fujian.
Se calcula que el tifón se desplaza en dirección a China a 11 km/h.	The typhoon is estimated to be moving toward China at eleven kph.
Ayer, el Twin Otter había realizado intentos de aterrizaje en Kokoda, como vuelo CG4684 de la aerolínea PNG, pero ya había abortado una vez.	The Twin Otter had been trying to land at Kokoda yesterday as Airlines PNG Flight CG4684, but had aborted once already.
Desapareció unos diez minutos antes de que tuviera que aterrizar desde su segundo acercamiento.	About ten minutes before it was due to land from its second approach it disapeared.
Hoy se localizó el lugar del accidente y dada su inaccesibilidad, fue preciso bajar a dos policías a la jungla para que pudieran llegar a pie hasta el lugar en busca de sobrevivientes.	The crash site was located today and is so inaccessable that two policemen were dropped into the jungle in order to hike to the scene and seek survivors.
Fueron las mismas condiciones climáticas que habían frustrado el aterrizaje las que impidieron la búsqueda.	The search had been hampered by the same bad weather that had caused the aborted landing.
Según se informó, explotó un apartamento en Macbeth Street, a causa de una fuga de gas.	According to reports, an apartment on Macbeth Street exploded due to a gas leak.
Un empleado de la compañía de gas se acercó al lugar, a raíz de la llamada de un vecino alertando sobre una fuga de gas.	An official with the gas company was reporting to the scene after a neighbor called about a gas leak.
Cuando el empleado llegó, el departamento explotó.	When the official arrived, the apartment exploded.
No se informó la existencia de heridos graves, pero se dio tratamiento a, por lo menos, cinco personas por síntomas de shock que se encontraba en la escena al momento de la explosión.	No major injuries were reported, but at least five people on scene at the time of the explosion were treated for symptoms of shock.
Dentro del apartamento no había nadie.	No one was inside the apartment.
En ese momento, se evacuó a cerca de 100 residentes de la región.	At the time, nearly 100 residents were evacuated from the area.
No menos de 100 invitados habían concurrido a la fiesta con el fin de celebrar el primer aniversario de la pareja, cuya boda había tenido lugar un año atrás.	At least 100 people had attended the party, in order to celebrate the first anniversary of a couple whose wedding was held last year.
Las autoridades informaron que se programó un evento formal de aniversario para otra fecha posterior.	A formal anniversary event was scheduled for a later date, officials said.
La pareja había contraído matrimonio en Texas un año atrás y vino a Búfalo para festejar con sus amigos y familiares.	The couple had married in Texas one year ago and came to Buffalo to celebrate with friends and relatives.
El cónyuge, de 30 años y oriundo de Búfalo, fue uno de los cuatro fallecidos en la balacera, pero su esposa no sufrió lesiones.	The 30-year-old husband, who was born in Buffalo, was one of the four killed in the shooting, but his wife was not hurt.
Dentro de la temporada de huracanes del Atlántico de 2010, Danielle es la cuarta tormenta tropical en ser nombrada y se originó en la parte oriental de dicho océano.	Tropical Storm Danielle, fourth named storm of the 2010 Atlantic hurricane season, has formed in the eastern Atlantic Ocean.
La tormenta, localizada a cerca de 3000 millas de Miami, Florida, presenta vientos que alcanzan una velocidad máxima constante de 40 mph (64 km/h).	The storm, located approximately 3,000 miles from Miami, Florida, has maximum sustained winds of 40 mph (64 kph).
Los expertos del Centro Nacional de Huracanes prevén que Danielle se intensificará y desencadenará un en huracán el día miércoles.	Scientists at the National Hurricane Center predict that Danielle will strengthen to a hurricane by Wednesday.
Debido a que la tormenta está lejos de llegar al suelo, aún se dificulta analizar el potencial impacto que tendrá en los Estados Unidos o en el Caribe.	As the storm is far from landfall, it remains difficult to assess potential impact to the United States or Caribbean.
Peter Lenz, un corredor de motocicletas de 13 años, falleció luego de participar en un accidente en el autódromo de Indianápolis.	Peter Lenz, a 13-year-old motorcycle racer, has died after being involved in a crash at the Indianapolis Motor Speedway.
Durante su vuelta de estrada en calor, Lenz cayó de su bicicleta y fue luego arrollado por su compañero, Xavier Zayat.	While on his warm-up lap, Lenz fell off his bike, and was then struck by fellow racer Xavier Zayat.
Recibió atención médica inmediata en la pista y fue trasladado a un hospital local, donde falleció más tarde.	He was immediately attended to by the on-track medical staff and transported to a local hospital where he later died.
Zayat no resultó herido en el accidente.	Zayat was unhurt in the accident.
Conforme surge del último informe, las lecturas del nivel del mar señalan la formación de un tsunami y se detectó cierta actividad de este fenómeno en las cercanías de Pago Pago y Niue.	According to the latest bulletin, sea level readings indicated a tsunami was generated. There was some definite tsunami activity recorded near Pago Pago and Niue.
No se han informado mayores daños o heridos en Tonga, pero se interrumpió el servicio de electricidad de forma temporal, lo que, se supone, frustró la recepción por las autoridades tonganas de la advertencia de tsunami emitida por el PTWC.	No major damage or injuries have been reported in Tonga, but power was temporarily lost, which reportedly prevented Tongan authorities from receiving the tsunami warning issued by the PTWC.
Catorce escuelas en la costa de Hawái o en el área cercana a ella cerraron completamente el miércoles, a pesar de que se levantaron las advertencias.	Fourteen schools in Hawaii located on or near coastlines were closed all of Wednesday despite the warnings being lifted.
Los accidentes de avión son habituales en Irán, que tiene una flota antigua que no recibe buen mantenimiento, ya sea para operaciones civiles o militares.	Air accidents are common in Iran, which has an aging fleet that is poorly maintained both for civil and military operations.
Las sanciones impuestas a nivel internacional se han traducido en la imposibilidad de adquirir nuevos aviones.	International sanctions have meant that new aircraft cannot be purchased.
Tres personas murieron y otras tres resultaron heridas a raíz de un accidente de un helicóptero policial ocurrido a comienzos de esta semana.	Earlier this week, a police helicopter crash killed three people and wounded three more.
El mes pasado, Irán vivió una de sus peores catástrofes aéreas en años cuando un avión de línea con dirección a Armenia se estrelló, causando el deceso de los 168 pasajeros a bordo.	Last month Iran saw its worst air disaster in years when an airliner heading to Armenia crashed, killing the 168 on board.
El mismo mes, otro avión de pasajeros sobrepasó una pista en Mashhad y colisionó contra una pared, dejando 17 muertos.	The same month saw another airliner overrun a runway at Mashhad and strike a wall, killing seventeen.
Mariana fue sacudida por un sismo a las 7:19 h hora local (21:19 h GMT) el viernes.	The eathquake struck Mariana at 07:19 a.m. local time (09:19 p.m. GMT Friday).
La agencia de manejo de emergencias de las Marianas del Norte indicó que no hubo registro de daños en el territorio nacional.	The Northern Marianas emergency management office said that there were no damages reported in the nation.
Asimismo, el Centro de Alerta de Tsunamis del Pacífico informó la ausencia de indicadores de tsunami.	Also the Pacific Tsunami Warning Center said that there was no Tsunami indication.
Xinhua informó que el miércoles los investigadores del gobierno lograron recuperar los registradores de vuelo de la caja negra.	Xinhua reported that government investigators recovered two 'black box' flight recorders on Wednesday.
