La hoja de los patines para hielo modernos cuenta con un filo de dos bordes separados por un espacio cóncavo entre ellos, lo que permite una mejor adherencia al hielo, incluso al estar inclinada.	The blade on a modern ice skate has a double edge with a concave hollow between them. The two edges allow for a better grasp of the ice, even when tilted.
Como la parte inferior de la cuchilla está levemente curvada, al inclinarla hacia un lado o el otro, el borde que queda en contacto con el hielo también se curva.	Because the bottom of the blade is slightly curved, as the blade tilts to one side or the other, the edge which is in contact with the ice also curves.
Esto hace que el patinador gire. Cuando los patines se inclinan hacia la derecha, el patinador también gira en esa dirección; si lo hacen hacia la izquierda, girará hacia la izquierda.	This causes the skater to turn. If the skates tilt to the right, the skater turns right, if the skates tilt to the left, the skater turns left.
Para recuperar el nivel de energía previo, deben deshacerse de la adicional que recibieron de la luz.	To return to their previous energy level, they must get rid of the extra energy they got from the light.
Se hace al emitir una pequeña partícula de luz llamada «fotón».	They do this by emitting a tiny particle of light called a "photon".
Los expertos denominan a este proceso «emisión estimulada de radiación», ya que la luz brillante estimula a los átomos, lo que genera la emisión de un fotón de luz, que es un tipo de radiación.	Scientists call this process "stimulated emission of radiation" because the atoms are stimulated by the bright light, causing the emission of a photon of light, and light is a type of radiation.
En la imagen que sigue se ilustran átomos que emiten fotones. Claro está, estos son, en verdad, de un tamaño mucho menor que los de la imagen.	The next picture shows the atoms emitting photons. Of course, in reality photons are a lot smaller than those in the picture.
¡El tamaño de los fotones es incluso menor que el de la materia que compone los átomos!	Photons are even smaller than the stuff that makes up atoms!
Tras funcionar por cientos de horas, el filamento en el foco eventualmente se quema y esta deja de funcionar.	After hundreds of hours of operation the filament in the bulb eventually burns out and the light bulb no longer works.
Luego, la bombilla debe cambiarse. Es necesario ser cuidadosos en el reemplazo.	The light bulb then needs replacing. It is necessary to be careful in replacing the light bulb.
Lo primero que se debe hacer con la lámpara es apagar su interruptor o desconectarla.	First, the switch for the light fixture needs to be turned off or the cable disconnected.
Esto ocurre porque la electricidad que corre hacia el casco en donde se inserta la parte metálica del foco puede causar una descarga eléctrica grave si se toca el interior de ese casco o la base de metal del foco mientras aún está parcialmente en el casco.	This is because electricity flowing into the socket where the metallic part of bulb sits can give you a severe electric shock if you touch the inside of the socket or the metal base of the bulb while it is still partly in the socket.
El tiempo es algo presente en todo lugar y que tiene efectos en todas nuestras acciones; sin embargo, es difícil comprenderlo.	Time is something that is all around us, and affects everything we do, yet is difficult to understand.
Tanto los eruditos religiosos, como los filosóficos y los científicos han estudiado al tiempo por miles de años.	Time has been studied by religious, philosophical, and scientific scholars for thousands of years.
Experimentamos el tiempo como una serie de acontecimientos que pasan desde el futuro a través del presente hacia el pasado.	We experience time as a series of events passing from the future through the present to the past.
El tiempo es también el modo en el que comparamos la duración (extensión) de los eventos.	Time is also how we compare the duration (length) of events.
Es posible para usted mismo marcar el paso del tiempo observando cómo se repite un evento cíclico; esto es, algo que se produce una y otra vez en forma regular.	You can mark the passing of time yourself by observing the repetition of a cyclical event. A cyclical event is something that happens again and again regularly.
En la actualidad, las personas usan las computadoras para manipular imágenes y videos.	Computers today are used to manipulate pictures and videos.
Es posible diseñar animaciones sofisticadas por ordenador, algo que es cada vez más habitual ver tanto en la televisión como en el cine.	Sophisticated animations can be constructed on computers, and this kind of animation is increasingly being used in television and films.
Con frecuencia, la grabación de música se hace con computadoras sofisticadas a fin de procesar y mezclar sonidos.	Music is often recorded using sophisticated computers to process and mix sounds together.
Las ciudades de Harappa y Mohenjo-daro tenían inodoros con descarga en casi todas las casas, los que se conectaban con un sistema de desagüe sofisticado.	The cities of Harappa and Mohenjo-daro had a flush toilet in almost every house, attached to a sophisticated sewage system.
En algunos hogares de las ciudades minoanas de Creta y Santorini, Grecia, se hallaron vestigios de sistemas de alcantarillas.	Remains of sewage systems have been found in the houses of the Minoan cities of Crete and Santorini in Greece.
También contaban con sanitarios en el antiguo Egipto, Persia y China. En la civilización romana, los baños públicos tenían retretes y algunos eran compartidos por hombres y mujeres.	There were also toilets in ancient Egypt, Persia and China. In Roman civilization, toilets were sometimes part of public bath houses where men and women were together in mixed company.
Cuando uno se comunica con alguien que está a miles de millas de distancia, se está haciendo uso de un satélite.	When you call someone who is thousands of miles away, you are using a satellite.
El satélite en el espacio recibe la llamada y, luego, la refleja de vuelta casi de forma instantánea.	The satellite in space gets the call and then reflects it back down, almost instantly.
El satélite fue enviado al espacio a través de un cohete. Los científicos utilizan telescopios en el espacio, dado que la luz de la atmósfera de la Terra distorsiona parte de la luz y vista que tenemos.	The satellite was sent into space by a rocket. Scientists use telescopes in space because the Earth’s atmosphere distorts some of our light and view.
Se precisa un cohete gigante, de más de 100 pies de altura, para poder llevar un satélite o telescopio al espacio exterior.	It takes a giant rocket over a 100 feet high to put a satellite or telescope in space.
La rueda ha modificado al mundo de formas sorprendentes. Lo más relevante que ha hecho por nosotros fue brindarnos un transporte mucho más simple y veloz.	The wheel has changed the world in incredible ways. The biggest thing that the wheel has done for us is given us much easier and faster transportation.
Gracias a ella hoy tenemos muchos medios de transporte, como el ferrocarril o el automóvil, entre tantos otros.	It has brought us the train, the car, and many other transportation devices.
La marca de «arco hacia arriba» se asemeja a una V y la marca de «arco hacia abajo» es similar a una grapa o un cuadrado sin su borde inferior.	The "up bow" mark looks like a V and the "down bow mark" like a staple or a square missing its bottom side.
Arriba quiere decir que se debe empezar en la punta y empujar el arco, y abajo significa que se debe comenzar en la rana, donde la mano sostiene el arco, y tirar de este.	Up means you should start at the tip and push the bow, and down means you should start at the frog (which is where your hand is holding the bow) and pull the bow.
El movimiento ascendente del arco genera un sonido más suave, en tanto que uno descendente es más fuerte y tajante.	An up-bow usually generates a softer sound, while a down-bow is stronger and more assertive.
Siéntase libre de hacer sus propias marcas con lápiz, pero no olvide que las marcas en los instrumentos de arco han sido impresas en ese lugar por con un propósito musical y, por tanto, deberían respetarse.	Feel free to pencil in your own marks, but remember the printed bowing marks are there for a musical reason, so they should usually be respected.
Por ello, cuando se inventó, el lápiz ganó muchos amigos.	Thus, the pencil was a good friend to many people when it came out.
Desafortunadamente, a raíz de la implementación de nuevos métodos de escritura, el lápiz se utiliza menos y ha perdido su estatus.	Sadly, as newer methods of writing have emerged, the pencil has been relegated to lesser status and uses.
Hoy en día, las personas escriben mensajes en las pantallas de sus computadoras. No tienen la necesidad de, siquiera, aproximarse a un sacapuntas.	People now write messages on computer screens, never having to come close to a sharpener.
Solo queda preguntarse qué será del teclado cuando surja algo más nuevo.	One can only wonder what the keyboard will become when something newer comes along.
La bomba atómica opera en base al principio de que se requiere energía para conformar un núcleo con gran cantidad de protones y neutrones.	The fission bomb works on the principle that it takes energy to put together a nucleus with many protons and neutrons.
Es similar a lo que sucede al rodar un carro pesado en ascenso por una colina. Al dividir el núcleo una vez más, libera parte de esa energía.	Sort of like rolling a heavy cart up a hill. Splitting the nucleus up again then releases some of that energy.
Los núcleos de algunos átomos son inestables, es decir que tienden a descomponerse con un mínimo o casi ningún empujón.	Some atoms have unstable nuclei which means that they tend to break apart with little or no nudging.
