Durante el calor diurno, es posible que los turistas vean espejismos que generan la ilusión de visualizar agua, entre otros.	In the heat of the day, travelers can experience mirages that give the illusion of water (or other things).
Estos pueden ser peligrosos si el viajero sigue el espejismo, lo que hará que desperdicie energía valiosa y el agua restante.	These can be dangerous if the traveler pursue the mirage, wasting precious energy and remaining water.
Hasta los desiertos más cálidos pueden tornarse dramáticamente fríos durante la noche. Si no cuenta con ropa de abrigo, corre un riesgo real de sufrir de hipotermia.	Even the hottest of deserts can become extremely cold at night. Hypothermia is a real risk without warm clothing.
Si decide hacer una caminata por la selva tropical, deberá cuidarse de los mosquitos, sobre todo durante el verano.	In summer, especially, you'll need to watch out for mosquitoes if you decide to hike through the rainforest.
Aun si está conduciendo por la selva subtropical y abre las puertas solo unos segundos para entrar al vehículo, eso es suficiente para que los mosquitos suban con usted.	Even if you're driving through the subtropical rainforest, a few seconds with the doors open while you get inside the vehicle is enough time for mosquitoes to get in the vehicle with you.
La gripe aviar, denominada con mayor formalidad influenza aviar, puede afectar a aves y mamíferos.	Bird flu, or more formally avian influenza, can infect both birds and mammals.
Aun cuando se han registrado menos de mil casos en personas, algunos de estos tuvieron un desenlace fatal.	Fewer than a thousand cases have ever been reported in humans, but some of them have been fatal.
Si bien casi todos los afectados tenían contacto en sus trabajos con aves de corral, también puede haber algún riesgo para los observadores de aves.	Most have involved people who work with poultry, but there is also some risk to birdwatchers.
En Noruega son típicos los fiordos y valles de gran pendiente que de pronto abren paso a una meseta elevada, más o menos homogénea.	Typical for Norway are steep fjords and valleys that suddenly give way to a high, more or less even plateau.
Suele llamarse vidde a estas mesetas, término que significa espacio amplio y abierto sin árboles; es decir, extensión ilimitada.	These plateaus are often referred to as "vidde" meaning a wide, open treeless space, a boundless expanse.
Es común que en Rogaland y Agder se les llame hei, que quiere decir páramo sin árboles, usualmente cubierto de brezos.	In Rogaland and Agder they are usually called "hei" meaning a treeless moorland often covered in heather.
Los glaciares no son inmóviles, sino que fluyen montaña abajo, lo cual origina grietas o hendiduras que podrían quedar ocultas por puentes de nieve.	The glaciers are not stable, but flow down the mountain. This will cause cracks, crevasses, which may be obscured by snow bridges.
Podrían colapsar los muros y los techos de las cuevas de hielo, y cerrarse las grietas.	The walls and roofs of ice caves can collapse and cracks can get closed.
Inmensos bloques se desprenden y caen de los bordes de los glaciares y, a veces, saltan o ruedan más lejos del borde.	At the edge of glaciers huge blocks break loose, fall down and perhaps jump or roll farther from the edge.
En las estaciones de montaña de la India, la temporada alta de turistas, por lo habitual, llega a su punto más alto durante el verano.	The tourist season for the hill stations generally peaks during the Indian summer.
De todas formas, su belleza y encanto en época invernal son especiales, con un gran número de estaciones de montaña en las que nieva en cantidades provechosas, posibilitando la práctica de deportes como el esquí y tabla nieve.	However, they have a different kind of beauty and charm during winter, with many hill stations receiving healthy amounts of snow and offering activities such as skiing and snowboarding.
En la actualidad, por lo general, los observatorios premodernos han quedado obsoletos y permanecen funcionando como museos o destinos educativos.	Pre-modern observatories are usually obsolete today, and remain as museums, or sites of education.
Dado que, en su auge, la contaminación lumínica no era un problema de gran magnitud como lo es hoy, es frecuente encontrarlos en ciudades o en campus, siendo de más fácil acceso que aquellos que se construyen en los tiempos modernos.	As light pollution in their heyday was not the kind of problem it is today, they are usually located in cities or at campuses, easier to reach than those built in modern times.
La mayor parte de los telescopios de investigación actuales consisten en inmensas estructuras instaladas en áreas alejadas con condiciones atmosféricas propicias.	Most modern research telescopes are enormous facilities in remote areas with favorable atmospheric conditions.
La contemplación de los cerezos en flor, denominada hanami, es tradicional de Japón desde el siglo VIII.	Cherry blossom viewing, known as hanami, has been a part of Japanese culture since the 8th century.
El concepto vino de China, donde la flor del ciruelo era la más apreciada.	The concept came from China where plum blossoms were the flower of choice.
Fue el emperador de Japón quien organizó las primeras celebraciones de los cerezos, solo para él y otros integrantes de la aristocracia de la Corte Imperial.	In Japan, the first cherry blossom parties were hosted by the emperor only for himself and other members of the aristocracy around the Imperial Court.
Las plantas lucen mejor cuando están en un entorno natural, por eso, resista la tentación de arrancar «tan solo un» espécimen.	Plants look their best when in a natural environment, so resist the temptation to remove even "just one" specimen.
Si recolecta «especímenes» durante una visita a un jardín organizado formalmente, provocará que lo expulsen, sin lugar a debate.	If visiting a formally arranged garden, collecting "specimens" is also going to get you ejected, without discussion.
Por lo general, Singapur es un lugar muy seguro para estar y muy sencillo de recorrer; además, puede comprar casi cualquier producto desde su arribo.	Singapore is generally an extremely safe place to be and very easy to navigate, and you can buy almost anything after arriving.
Pero, debido a su ubicación en los «trópicos altos», a unos pocos grados al norte del ecuador, usted deberá lidiar siempre con el calor y, cuando el cielo está despejado, con el sol fuerte, lo que sucede con menor frecuencia.	But being placed in the "high tropics" just a few degrees north of equator you will need to deal with both heat (always) and strong sun (when the sky is clear, more rarely).
Además, algunos autobuses se dirigen hacia Hebrón, al norte, que es el sitio donde, según la historia, se enterró a los patriarcas bíblicos Abraham, Isaac, Jacob y sus mujeres.	There are also a few buses going north to Hebron, the traditional burial place of the Biblical patriarchs Abraham, Isaac, Jacob, and their wives.
Debe corroborar que el autobús al que piensa subirse va con dirección a Hebrón y no solo a Kyriat Arba, que es un barrio judío que queda cerca de ese lugar.	Check that the bus you are thinking of taking goes into Hebron and not just to the nearby Jewish settlement of Kiryat Arba.
Los canales navegables internos pueden ser una buena temática para las vacaciones.	Inland waterways can be a good theme to base a holiday around.
Por ejemplo, visitar castillos del valle del Loira, del valle del Rin, tomar un crucero hacia destinos interesantes por el Danubio, o recorrer en bote el canal de Erie.	For example visiting castles in the Loire Valley, the Rhine valley or taking a cruise to interesting cites on the Danube or boating along the Erie Canal.
También delimitan las rutas para populares caminos de senderismo y ciclismo.	They also define routes for popular hiking and cycling trails.
Todos animales que originariamente llegaron a las islas vinieron a este lugar nadando, volando o flotando.	All animals that originally arrived in the islands came here either by swimming, flying or floating.
Debido a que se encuentran muy alejadas del continente, los mamíferos no lograban llegar hasta allí, lo que hizo que la tortuga gigante se volviera la principal criatura de pastoreo en las Galápagos.	Due to the long distance from the continent mammals were unable to make the journey making the giant tortoise the primary grazing animal in the Galapagos.
Muchas especies mamíferas han sido introducidas en Galápagos desde que el hombre llegó al archipiélago, como, por ejemplo, el ganado caprino, equino y vacuno, o los roedores, lo canes y los felinos.	Since the arrival of man to the Galapagos, many mammals have been introduced including goats, horses, cows, rats, cats and dogs.
Si viaja a las regiones árticas o antárticas en época invernal, vivirá la experiencia de la noche polar, que significa que el sol no se alza por encima del horizonte.	If you visit the Arctic or Antarctic areas in the winter you will experience the polar night, which means that the sun doesn't rise above the horizon.
Dado que el cielo se mantendrá oscuro casi durante todo el día, es una gran oportunidad para contemplar las auroras boreales.	This offers a good opportunity to see the Aurora borealis, as the sky will be dark more or less around the clock.
Gracias a la escasa población que reside en dichas regiones y a que, producto de ello, no suele haber problemas de contaminación lumínica, también podrá deleitarse con las estrellas.	As the areas are sparsely populated, and light pollution therefore often not a problem, you will also be able to enjoy the stars.
