Prima del Velocirráptor, la Hesperonychus elizabethae pertenece a la familia Dromaeosauridae.	Hesperonychus elizabethae is a species of the family Dromaeosauridae and is a cousin of Velociraptor .
Se creía que esta ave rapaz, plumífera y de sangre caliente se desplazaba erguida sobre un par de patas con garras, al igual que el Velociráptor.	This fully feathered, warm blooded bird of prey was believed to have walked upright on two legs with claws like the Velociraptor.
Su segunda garra era más grande y de allí surgió el nombre Hesperonychus, cuyo significado es «garra occidental».	Its second claw was larger, giving rise to the name Hesperonychus which means "western claw."
Se espera que, al momento del ingreso a la atmósfera de la cápsula, cuando esta llegue a la Tierra, lo que ocurrirá cerca de las 5 de la mañana (hora del este), produzca un espectáculo de muchas luces visible para las personas del norte de California, Oregón, Nevada y Utah.	When the capsule gets to Earth and enters the atmosphere, at about 5am (eastern time), it is expected to put on quite a light show for folks in Northern California, Oregon, Nevada, and Utah.
La cápsula tendrá un gran parecido a una estrella fugaz que atraviesa el firmamento.	The capsule will look much like a shooting star going across the sky.
La cápsula tendrá una velocidad de 12,8 km (8 mi) por segundo, suficiente para llegar a los Ángeles desde San Francisco en un minuto.	The capsule will be traveling at about 12.8 km or 8 miles per second, fast enough to go from San Francisco to Los Angeles in one minute.
Stardust impondrá un nuevo récord histórico por ser la nave espacial más rápida en retornar a la tierra, batiendo el anterior de mayo de 1969, que había sido alcanzado durante el regreso del módulo de comando Apolo X.	Stardust will set a new all-time record for being the fastest spacecraft to return to Earth, breaking the previous record set in May of 1969 during the return of the Apollo X command module.
«Se desplazará por la costa oeste del norte de California y llenará el cielo de luz desde California pasando por el centro de Ohio y luego a través de Nevada e Idaho, hasta Utah», afirmó Tom Duxbury, gerente del proyecto de Stardust.	“It will move over the west coast of northern California and will light the sky from California through central Oregon and on through Nevada and Idaho and into Utah,” Tom Duxbury, Stardust's project manager said.
Se trata de la adquisición más importante en toda la historia de eBay.	It is the biggest acquisition in eBay's history.
La empresa tiene como objetivo diversificar sus fuentes de ingresos y ganar popularidad en zonas en donde Skype goza de una posición contundente, como China, Europa del Este y Brasil.	The company hopes to diversify its profit sources and gain popularity in areas where Skype holds a strong position, such as China, Eastern Europe, and Brazil.
Los científicos sospechan que Encélado es geológicamente activo y una posible fuente del anillo E de hielo de Saturno.	Scientists have suspected Enceladus as geologically active and a possible source of Saturn's icy E ring.
El encélado es el cuerpo más reflectante del sistema solar, ya que refleja cerca del 90 por ciento de la luz proveniente del sol que lo impacta.	Enceladus is the most reflective object in the solar system, reflecting about 90 percent of the sunlight that hits it.
Basándose en este fósil, puede concluirse que la división ocurrió mucho antes de lo que indica la evidencia molecular.	"Based on this fossil, that means the split is much earlier than has been anticipated by the molecular evidence.
«Esto quiere decir que todo debe llevarse hacia atrás», indicó Berhance Asfaw, investigador para el Servicio de Investigación del Valle del Rift en Etiopía y coautor del estudio.	That means everything has to be put back," said researcher at the Rift Valley Research Service in Ethiopia and a co-author of the study, Berhane Asfaw.
Se cree que esta es la quinta oportunidad en la historia en que las personas han podido ver la caída sobre la Tierra de lo que fue químicamente confirmado como material marciano.	This is believed to be the fifth time in history that people have observed what turned out to be chemically confirmed martian material falling to Earth.
De los cerca de 24 000 meteoritos que se sabe han impactado sobre la Tierra, se ha corroborado que tan solo 34 son de provienen de Marte.	Out of the approximately 24,000 known meteorites to have fallen to Earth, only about 34 have been verified to be martian in origin.
Se adjudicaron quince de estas rocas a la lluvia de meteoritos ocurrida en julio pasado.	Fifteen of these rocks are attributed to the meteorite shower last July.
Algunas de las rocas, muy poco comunes en la Tierra, se venden entre $11 000 y $22 500 dólares por onza, que representa aproximadamente diez veces el precio del oro.	Some of the rocks, which are very rare on Earth, are being sold from US$11,000 to $22,500 per ounce, which is about ten times more than the cost of gold.
La energía oscura es una fuerza totalmente fuera del alcance de la vista que opera continuamente sobre el universo.	Dark energy is a completely invisible force that is constantly acting upon the universe.
Su sabe de su existencia solo por la forma en que afecta la expansión del universo.	Its existence is known only because of its effects on the expansion of the universe.
Los científicos han hallado accidentes geográficos desparramados sobre la superficie lunar denominados escarpes lobulados, que parecen ser el resultado del achicamiento muy lento que experimenta este satélite.	Scientists have discovered landforms littered across the moon's surface called lobate scarps that have apparently resulted from the moon's shrinking very slowly.
Estos declives ásperos fueron hallados por toda la superficie lunar y lucen mínimamente erosionados, lo que supone que los fenómenos geológicos que le dieron origen fueron bastante recientes.	These scarps were found all over the moon and appear to be minimally weathered, indicating that the geologic events that created them were fairly recent.
Esta premisa se enfrenta con la que sostiene que la luna no presenta ningún tipo de actividad geológica.	This theory contradicts the claim that the moon is completely devoid of geologic activity.
Se comportará igual que el agua. Es transparente, tal como lo es el agua.	"It's going to behave like water. It's transparent just the way water is.
Por lo tanto, si estuviera de pie junto a la orilla, podría observar cualquier pequeña piedra o porquería que hubiese en el fondo.	So if you were standing by the shoreline, you would be able to see down to whatever pebbles or gunk that was on the bottom.
«Por lo que sabemos hasta ahora, solo hay un planeta que presenta más dinamismo que Titán; se le llama Tierra», agregó Stofan.	As far as we know, there is only one planetary body that displays more dynamism than Titan, and its name is Earth," added Stofan.
El orbitador lunar sin tripulación, Chandrayaan-1, expulsó su Sonda de Impacto Lunar (MIP), que se precipitó en la superficie de la Luna a 1,5 kilómetros por segundo (3000 millas por hora) y aterrizó estrellándose con éxito cerca del polo sur del satélite natural.	The unmanned lunar orbiter Chandrayaan-1 ejected its Moon Impact Probe (MIP), which hurtled across the surface of the Moon at 1.5 kilometres per second (3000 miles per hour), and successfully crash landed near the Moon's south pole.
Además de tres equipos científicos de gran importancia, la sonda lunar también fue protagonizada por la bandera nacional india, visible en todos los lados.	Besides carrying three important scientific instruments, the lunar probe also carried the image of the Indian national flag, painted on all sides.
Leonov, también llamado el «cosmonauta n.º 11», integró la tripulación original de cosmonautas de la Unión Soviética.	Leonov, also known as "cosmonaut No. 11", was part of the Soviet Union's original team of cosmonauts.
En marzo de 1965, realizó la primera actividad extravehicular (EVA), o paseo espacial tripulado, donde estuvo solo fuera de la nave durante algo más de doce minutos.	On March 18, 1965, he performed the first manned extravehicular activity (EVA), or "spacewalk", remaining alone outside the spacecraft for just over twelve minutes.
Por su labor, le fue entregada la distinción «Héroe de la Unión Soviética», el mayor honor de ese estado.	He received the "Hero of the Soviet Union", the Soviet Union's highest honor, for his work.
Diez años después, estuvo al mando de la participación soviética en la misión Apollo-Soyuz, que simbolizaba el fin de la Carrera Espacial.	Ten years later, he led the Soviet part of the Apollo–Soyuz mission symbolizing that the Space Race was over.
A pesar de haber perdido un giroscopio previamente en la misión de la estación espacial, la misma mantuvo su altitud hasta que se completó la caminata espacial.	The station maintained its attitude, despite the loss of a gyroscope earlier in the space station mission, until the end of the spacewalk.
Chiao y Sharipov indicaron que estaban a una distancia prudencial de los propulsores de control de actitud.	Chiao and Sharipov reported being a safe distance from the attitude adjustment thrusters.
Los aviones de reacción fueron activados por el control en tierra ruso y se recuperó el plan normal de la estación.	Russian ground control activated the jets and normal attitude of the station was regained.
El mapa internacional de terremotos del Servicio Geológico de EE. UU. no exhibió movimientos sísmicos en Islandia la semana previa.	The United States Geological Survey international earthquake map showed no earthquakes in Iceland in the week prior.
Tampoco la Oficina Meteorológica de Islandia reportó actividad sísmica en Hekla durante las pasadas 48 horas.	The Icelandic Meteorological Office also reported no earthquake activity in the Hekla area in the past 48 hours.
Los movimientos sísmicos de gran magnitud que causaron el cambio de fase ocurrieron el 10 de marzo, en el sector noreste de la caldera que se encuentra en la cima de este volcán.	The significant earthquake activity resulting in the phase change had took place on March 10 on the northeast side of the volcano's summit caldera.
Se registraron nubes oscuras en la base de la montaña que no guardan relación con actividad volcánica alguna.	Dark clouds unrelated to any volcanic activity were reported at the base of the mountain.
Las nubes constituían una posible causal de confusión sobre si realmente había tenido lugar una erupción.	The clouds presented the potential for confusion as to whether an actual eruption had taken place.
La tensión superficial provoca que la aguja permanezca flotando sobre el agua.	The steel needle floats on top of the water because of surface tension.
La tensión superficial se produce debido a que las moléculas de agua en su superficie se atraen con mucha más intensidad que las moléculas de aire suspendidas por encima de ellas.	Surface tension happens because the water molecules at the surface of the water are strongly attracted to each other more than they are to the air molecules above them.
Las moléculas de agua forman una película invisible sobre su superficie que permite que objetos como las agujas floten encima de ella.	The water molecules make an invisible skin on the water’s surface that allows things like the needle to float on top of the water.
Al producirse el cambio de la carrera de un cuarto a media milla, la velocidad pierde en gran medida su importancia, mientras que la resistencia se torna absolutamente necesaria.	With the change from the quarter to the half mile run, speed becomes of much less importance and endurance becomes an absolute necessity.
Desde ya, un corredor de la media milla de primera categoría, que puede superar los dos minutos, debe tener un buen nivel de velocidad, pero debe cultivar la resistencia a toda costa.	Of course a first-class half-miler, a man who can beat two minutes, must be possessed of a fair amount of speed, but endurance must be cultivated at all hazards.
La forma de prepararse para la temporada de carreras es la combinación de algo de carrera a campo traviesa durante la época invernal con un entrenamiento del tren superior del cuerpo en el gimnasio.	Some cross country running during the winter, combined with gymnasium work for the upper part of the body, is the best preparation for the running season.
No es posible que las prácticas nutricionales adecuadas, por sí solas, generen un rendimiento de elite, pero puede influir en gran medida el bienestar general de los atletas jóvenes.	Proper nutritional practices alone cannot generate elite performances, but they can significantly affect young athletes' overall wellness.
Tener un adecuado equilibrio energético, adoptar hábitos de hidratación eficaces y tomar conocimiento de los diferentes aspectos de las prácticas de suplementación puede contribuir a que los atletas incrementen su rendimiento y disfruten más del deporte.	Maintaining a healthy energy balance, practicing effective hydration habits, and understanding the various aspects of supplementation practices can help athletes improve their performance and increase their enjoyment of the sport.
La carrera de distancia media es un deporte relativamente económico; no obstante, existen muchos conceptos erróneos en relación con los pocos equipamientos requeridos para participar.	Middle distance running is a relatively inexpensive sport; however, there are many misconceptions regarding the few pieces of equipment required to participate.
Existen artículos que se pueden adquirir si se los estima necesarios; no obstante, la mayoría de ellos no tendrá impacto verdadero alguno en el rendimiento, o su incidencia será mínima.	Products can be purchased as needed, but most will have little or no real impact on performance.
Los atletas pueden sentir que prefieren un producto, aun cuando no le proporcione beneficios verdaderos.	Athletes may feel that they prefer a product even when it provides no real benefits.
El átomo puede ser considerado como una de las piedras angulares para la construcción toda la materia.	The atom can be considered to be one of the fundamental building blocks of all matter.
Es una estructura muy compleja que está formada, conforme el modelo simplificado de Bohr, por un núcleo central en torno al que orbitan electrones; algo similar a los planetas que giran alrededor del Sol. Ver Figura 1.1.	Its a very complex entity which consists, according to a simplified Bohr model, of a central nucleus orbited by electrons, somewhat similar to planets orbiting the sun - see Figure 1.1.
Son dos partículas las que componen el núcleo; estas son los protones y los neutrones.	The nucleus consists of two particles - neutrons and protons.
Mientras que los neutrones no tienen carga eléctrica, la de los protones es positiva y, la de los electrones, negativa.	Protons have a positive electric charge while neutrons have no charge. The electrons have a negative electric charge.
Para examinar a la víctima, usted primero debe inspeccionar la escena a efectos de garantizar su propia seguridad.	To Check the victim, you must first survey the scene to ensure your safety.
Debe observar la posición en la que se encuentra la víctima al ir acercándose a él o ella, así como cualquier señal de alerta automática.	You need to notice the victim's position as you approach him or her and any automatic red flags.
Si al intentar prestar ayuda resulta herido, es posible que solo empeore las cosas.	If you get hurt trying to help, you may only serve to make matters worse.
El estudio determinó que la depresión, el miedo y la sobredimensión intervinieron en la dinámica entre el dolor y la discapacidad en los pacientes con dolencias en la región lumbar.	The study found that depression, fear and catastrophising mediated the relationship between pain and disability in lower back pain sufferers.
Solo los efectos de la catastrofización, no de la depresión o del miedo, estaban condicionados a sesiones de AF estructuradas, semanales y regulares.	Only the effects of catastrophizing, not depression and fear was conditional of regular weekly structured PA sessions.
Los que participaban en actividades regulares demandaban mayor apoyo en cuanto a percepción negativa del dolor, marcando las distinciones entre el dolor crónico y la sensación de malestar presente en el movimiento físico habitual.	Those participating in regular activity required more support in terms of negative perception of pain distinguishing the differences of chronic pain and discomfort feel from normal physical movement.
La vista, o la capacidad de ver, está a cargo de los órganos sensoriales (ojos) del sistema visual.	Vision, or the ability to see depends on visual system sensory organs or eyes.
Existen numerosas estructuras oculares distintas; su complejidad varía en función de las necesidades del organismo.	There are many different constructions of eyes, ranging in complexity depending on the requirements of the organism.
Las distintas construcciones tienen diferentes capacidades, son susceptibles de tener distintas longitudes y grados de agudeza; también requieren un procesamiento diferenciado para dar sentido a la entrada y números disímiles para que funcionen de forma óptima.	The different constructions have different capabilities, are sensitive to different wave-lengths and have differing degrees of acuity, also they require different processing to make sense of the input and different numbers to work optimally.
Una población es la reunión de organismos de una misma especie en particular dentro una zona geográfica específica.	A population is the collection of organisms of a particular species within a given geographic area.
Cuando los individuos miembros una población comparten algún rasgo fenotípico particular de forma idéntica, se los denomina monomórficos.	When all individuals in a population are identical with regard to a particular phenotypic trait they are known as monomorphic.
Se llama polimórficos a quienes exhiben diversas variantes de un mismo rasgo.	When the individuals show several variants of a particular trait they are polymorphic.
Las colonias de hormigas guerreras también caminan y hacen nidos en diferentes fases.	Army ant colonies march and nest in different phases as well.
Durante la etapa nómada, las hormigas guerreas avanzan por la noche y, de día, se detienen para acampar.	In the nomadic phase, army ants march at night and stop to camp during the day.
La colonia empieza una fase nómade cuando la comida disponible disminuye. En esta fase, forman nidos temporales que se cambian a diario.	The colony begins a nomadic phase when available food has decreased. During this phase, the colony makes temporary nests that are changed everyday.
Cada uno de estos desmadres o marchas errantes dura aproximadamente 17 días.	Each of these nomadic rampages or marches lasts for approximately 17 days.
¿Qué es una célula? Este término deriva del latín cella, que significa «cuarto de tamaño reducido», y fue empleado por primera vez por un microscopista mientras estudiaba la estructura del corcho.	What is a cell? The word cell comes from the Latin word "cella", meaning "small room", and it was first coined by a microscopist observing the structure of cork.
La unidad básica de todo ser vivo es la célula y cada organismo está formado por una o más de ellas.	The cell is the basic unit of all living things, and all organisms are composed of one or more cells.
Las células son básicas y cruciales para el estudio de la vida. En efecto, con frecuencia se les dice «los componentes básicos de la vida».	Cells are so basic and critical to the study of life, in fact, that they are often referred to as "the building blocks of life".
El sistema nervioso mantiene la homeostasis a través de impulsos nerviosos que envía a todo el cuerpo para que el flujo sanguíneo corra sin interrupciones.	The Nervous System maintains homeostasis by sending nerve impulses through out the body to keep the flow of blood going as well as undisturbed.
Estos impulsos nerviosos pueden ser enviados velozmente a través del organismo, lo cual contribuye a mantenerlo a salvo de cualquier amenaza potencial.	These nerve impulses can be sent so quickly throughout the body which helps keep the body safe from any potential threat.
Si bien las superficies que azotan los tornados son pequeñas, comparadas con otras tormentas agresivas, pueden destruir todo en su camino.	Tornadoes strike a small area compared to other violent storms, but they can destroy everything in their path.
Los tornados desarraigan árboles, arrancan paneles de los edificios y lanzan vehículos al cielo. El 2 % más agresivo de los tornados dura más de tres horas.	Tornadoes uproot trees, rip boards from buildings, and fling cars up into the sky. The most violent two percent of tornadoes last more than three hours.
Estas colosales tormentas traen ráfagas de hasta 480 km/h (133m/s; 300 mph).	These monster storms have winds up to 480 km/h (133 m/s; 300 mph).
Por milenios y milenios las personas han fabricado y utilizando lentes de aumento.	Humans have been making and using lenses for magnification for thousands and thousands of years.
Sin embargo, los primeros verdaderos telescopios se desarrollaron en Europa, a fines del siglo XVI.	However, the first true telescopes were made in Europe in the late 16th century.
Estos telescopios empleaban una combinación de dos lentes para que los objetos lejanos parecieran estar más cercanos y tener mayor tamaño.	These telescopes used a combination of two lenses to make distant objects appear both nearer and larger.
La codicia y el egoísmo siempre estarán con nosotros y la esencia de la cooperación radica en que, cuando la mayoría se beneficia, siempre habrá más por ganar a corto plazo si se actúa de forma egoísta.	Greed and selfishness will always be with us and it is the nature of cooperation that when the majority benefit there will always be more to gain in the short term by acting selfishly
Con suerte, la mayoría de las personas toman consciencia de que su mejor opción en el largo plazo es la de trabajar en colaboración con otros.	Hopefully, most people will realise that their long term best option is to work together with others.
Según los expertos, la explosión que generó la colisión fue masiva.	Scientists say the explosion caused by the collision was massive.
Aún intentan establecer cuán importante fue el impacto y de qué modo afectará al planeta.	They are still trying to determine just how large the crash was and how the Earth will be affected.
El Comando Estratégico de EE. UU., que depende de la oficina del Departamento de Defensa, realiza un rastreo de los restos.	The United States Strategic Command of the U.S. Department of Defense office is tracking the debris.
El resultado del análisis de rastreo se dará a conocer en un sitio web de acceso libre.	The result of plotting analysis will be posted to a public website.
El diámetro de todas las entradas a la cueva, conocidas como «Las Siete Hermanas», es de, cuando menos, 100 m a 250 m (328 a 820 pies).	All of the cave entrances, which were named "The Seven Sisters", are at least 100 to 250 meters (328 to 820 feet) in diameter.
Conforme surge de las imágenes infrarrojas, las variaciones de temperatura durante la noche y el día indican que, probablemente, se trate de cuevas.	Infrared images show that the temperature variations from night and day show that they are likely caves.
Durante el día, su temperatura es más baja que la de la superficie que la rodea y, por las noches, más alta.	"They are cooler than the surrounding surface in the day and warmer at night.
«Si bien su comportamiento térmico no es tan regular como las grandes cuevas en nuestro planeta, que suelen sostener una temperatura bastante estable, es consistente con estas profundas cavidades en el suelo», sostuvo Glen Cushing, del equipo de arqueología del Servicio Geológico Estadounidense (USGS) y de la Universidad del Norte de Arizona, en Flagstaff, Arizona.	Their thermal behavior is not as steady as large caves on Earth that often maintain a fairly constant temperature, but it is consistent with these being deep holes in the ground," said Glen Cushing of the United States Geological Survey (USGS) Astrogeology Team and of Northern Arizona University located in Flagstaff, Arizona.
ASUS Eee PC, que anteriormente fue lanzada a nivel global por sus ventajas de ahorro de costos y funcionalidad, se volvió sujeto de candentes debates en el Mes de la Tecnología de la Información de Taipei 2007.	ASUS Eee PC, earlier launched world-wide for cost-saving and functionality factors, became a hot topic in 2007 Taipei IT Month.
Pero el mercado de consumidores de computadoras portátiles se versificó drásticamente y cambió luego de que ASUS recibiera de manos del Yuan Ejecutivo de la República de China el Premio al Desarrollo Sostenible de Taiwán 2007.	But the consumer market on laptop computer will be radically varied and changed after ASUS was awarded in the 2007 Taiwan Sustainable Award by Executive Yuan of the Republic of China.
Pasados aproximadamente 3 minutos desde despegue, una cámara en el interior mostró numerosos trozos de espuma aislante desprendiéndose del tanque de combustible.	Around 3 minutes into the launch, an on-board camera showed numerous pieces of insulation foam break away from the fuel tank.
De todas formas, se cree que no han causado ningún daño al trasbordador.	However, they are not thought to have caused any damage to the shuttle.
N. Wayne Hale Jr., al mando del programa de transbordadores de la NASA, declaró que la espuma se había caído «en forma posterior al momento sobre el cual se centra nuestra preocupación».	NASA's shuttle program chief N. Wayne Hale Jr. said the foam had fallen "after the time we are concerned about."
Se han denunciado cerca de 60 casos de iPods con problemas de funcionamiento y calentamiento exesivo, lo que originó seis incendios y provocó quemaduras menores a cuatro personas.	Around 60 cases of malfunctioning iPods overheating have been reported, causing a total of six fires and leaving four people with minor burns.
El Ministerio de Economía, Comercio e Industria japonés (METI) informó haber registrado 27 accidentes que involucraban a estos aparatos.	Japan's Ministry of Economy, Trade and Industry (METI) said that it had been aware of 27 accidents related to the devices.
La semana pasada, METI anunció que Apple les había informado de 34 incidentes adicionales de sobrecalentamiento, que la compañía catalogó como «no graves».	Last week, METI announced that Apple had informed it of 34 additional overheating incidents, which the company called "non-serious."
El ministerio se pronunció en relación al retraso en el informe de Apple, diciendo que era algo «verdaderamente lamentable».	The ministry responded by calling Apple's postponement of the report "truly regrettable."
Liggins siguió el mismo camino que su padre y comenzó a estudiar medicina.	Liggins followed in his father’s footsteps and entered a career in medicine.
Recibió formación en obstetricia e ingresó a trabajar para el Hospital Nacional de Mujeres de Auckland hacia 1959.	He trained as an obstetrician and began to work at the Auckland's National Women's Hospital in 1959.
Liggins comenzó sus investigaciones sobre el parto prematuro en su tiempo libre, mientras trabajaba en el hospital.	While he was working at the hospital Liggins began to investigate premature labor during his spare time.
Su estudio demostró que la maduración pulmonar fetal del bebé podía ser agilizada a través de la administración de una hormona.	His research showed that if a hormone was administered it would speed up the baby's foetal lung maturation.
El 25 de enero, Curtis Cooper, matemático y profesor de ciencias de la informática en la Universidad de Central Misuri, descubrió el mayor número primo que se haya conocido.	Curtis Cooper, a mathematician and computer science professor at the University of Central Missouri, has discovered the largest known prime number to date on January 25.
Muchas personas comprobaron el hallazgo mediante el uso de varios tipos de hardware y software y a comienzos del mes de febrero y se dio a conocer el martes.	Several people verified the discovery using different hardware and software by the beginning of February and it was announced on Tuesday.
Posiblemente, los cometas hayan servido como fuente de suministro de agua para nuestro planeta, así como de materia orgánica, la cual tiene la capacidad de formar proteínas y sustentar la vida.	Comets may possibly have been a source of water delivery to the earth along with organic matter that can form proteins and support life.
La expectativa de los científicos es comprender cómo se originan los planetas, en particular el nuestro, dado que los cometas se estrellaron en la Tierra mucho tiempo atrás.	Scientists hope to understand how planets form, especially how the Earth formed, since comets collided with the Earth long ago.
El jueves, la revista Science dio a conocer una investigación que informaba sobre la aparición de una nueva especie de ave en las islas Galápagos ecuatorianas.	A study published on Thursday in the journal Science reported on formation of a new bird species on the Ecuadorean Galápagos Islands.
Expertos de la Universidad de Princeton, en EE. UU., y de la de Uppsala, en Suecia, dieron a conocer que la nueva especie logró evolucionar en tan solo dos generaciones, aun cuando se estimaba que demoraría mucho más, a causa de la reproducción entre un pinzón de Darwin endémico, Geospiza fortes, y un pinzón de cactus migrante, Geospiza conirostris.	Researchers from Princeton University in the United States and Uppsala University in Sweden reported the new species evolved in just two generations, though this process had been believed to take much longer, due to breeding between an endemic Darwin finch, Geospiza fortes, and the immigrant cactus finch, Geospiza conirostris.
Esto se denomina pH de una sustancia química. Usted puede elaborar un indicador de pH utilizando jugo de col roja.	This is called a chemical's pH. You can make an indicator using red cabbage juice.
El color del jugo de repollo se verá alterado en función de cuán ácida o básica (alcalina) sea la sustancia química.	The cabbage juice changes color depending on how acidic or basic (alkaline) the chemical is.
El número de iones de hidrógeno (la H en pH) presentes en el producto químico analizado determina su nivel de pH.	The pH level is indicated by the amount of Hydrogen (the H in pH) ions in the tested chemical.
Los átomos de hidrógeno están formados por un protón y un electrón. Por ello, un ion de hidrógeno es el resultado de despojar a un protón de su electrón.	Hydrogen ions are protons that had their electrons stripped off them (since Hydrogen atoms consist of one proton and one electron).
Agite ambos polvos secos juntos y, después de hacerlo, con las manos higienizadas y húmedas, exprímalos para formar una bola.	Swirl the two dry powders together and then, with clean wet hands, squeeze them into a ball.
Se producirá una reacción entre la humedad en sus manos y sus capas externas, las que se sentirán extrañas al tacto y formarán una especie de caparazón.	The moisture on your hands will react with the outer layers, which will feel funny and form a sort of shell.
Actualmente, casi todas las computadoras funcionan en base a la manipulación de datos codificados bajo el sistema binario.	Virtually all computers in use today are based on the manipulation of information which is coded in the form of binary numbers.
Un número binario únicamente puede tener uno de dos valores, ellos son el 0 y el 1 y, de acuerdo con la jerga informática, estos números se conocen como dígitos binarios, o bits.	A binary number can have only one of two values, i.e. 0 or 1, and these numbers are referred to as binary digits - or bits, to use computer jargon.
El envenenamiento interno puede no evidenciarse de inmediato. Sus síntomas, como, por ejemplo, el vómito, son demasiado habituales como para poder dar un diagnóstico inmediato.	Internal poisoning may not be immediately apparent. Symptoms, such as vomiting are sufficiently general that an immediate diagnosis cannot be made.
El más claro indicador de envenenamiento interno puede ser encontrar con un frasco abierto de medicinas o de productos de limpieza químicos tóxicos.	The best indication of internal poisoning may be the presence of an open container of medication or toxic household chemicals.
Lea la etiqueta para contar con información específica sobre los primeros auxilios pertinentes para ese veneno específico.	Check the label for specific first aid instructions for that specific poison.
Los entomólogos emplean el término insecto parásito en un sentido formal para referirse a este grupo de artrópodos.	The term bug is used by entomologists in a formal sense for this group of insects.
La palabra proviene de su antigua relación con las chinches, especie muy desarrollada para parasitar a los humanos.	This term derives from ancient familiarity with Bed-bugs, which are insects highly adapted to parasitize humans.
Las chinches asesinas y las de cama son nidícolas; están adaptadas para habitar el nido u hogar de su anfitrión.	Both Assassin-bugs and Bed-bugs are nidicolous, adapted to living in nest or housing of their host.
Los casos registrados de esclerosis múltiple (EM) en EE. UU. ascienden a cerca de 400 000, lo que la hace la enfermedad neurológica más frecuente entre adultos jóvenes y de mediana edad.	Across the United States of America, there are approximately 400,000 known cases of Multiple Sclerosis (MS), leaving it as the leading neurological disease in younger and middle aged adults.
El sistema nervioso central, unión del cerebro, la médula espinal y el nervio óptico, es el objeto de ataque de la esclerosis múltiple.	MS is a disease that affects the central nervous system, which is made up of the brain, the spinal cord and the optic nerve.
Los estudios indicaron que las mujeres tienen el doble de probabilidades que los hombres de padecer EM.	Research has found that females are two times more likely to have MS then males.
Una pareja podría concluir que criar a un bebé no sería lo más conveniente para ellos o para el niño.	A couple may decide it is not in their best interest, or in the interest of their child, to raise a baby.
Estas parejas podrían elegir planificar la adopción de un bebé.	These couples may choose to make an adoption plan for their baby.
En una adopción, los padres biológicos renuncian a sus derechos parentales para que una pareja distinta pueda hacerse cargo del niño.	In an adoption, the birth parents terminate their parental rights so that another couple may parent the child.
El objetivo capital de la ciencia es descifrar el modo en que funciona el mundo a través del método científico. En efecto, este método sirve de guía para la mayor parte de las investigaciones científicas.	Science’s main goal is to figure out the way the world works through the scientific method. This method in fact guides most scientific research.
No se trata, sin embargo, de una experimentación, es una prueba que se usa para descartar una o más de las posibles hipótesis, haciendo preguntas y observaciones que guían la investigación científica.	It isn’t alone though, experimentation, and an experiment is a test that is used to eliminate one or more of the possible hypotheses, asking questions, and making observations also guide scientific research.
El foco tanto de naturalistas como de filósofos fue puesto en las obras clásicas; especialmente, en la versión en latín del texto bíblico.	Naturalists and philosophers focused on classical texts and, in particular, on the Bible in Latin.
Los pensamientos de Aristóteles, en especial las cuestiones de la ciencia, incluso la psicología, fueron aceptadas.	Accepted were Aristotle's views on all matters of science, including psychology.
A medida que el dominio del idioma griego fue decayendo, Occidente se distanció de sus raíces griegas tanto filosóficas como científicas.	As knowledge of Greek declined, the West found itself cut off from its Greek philosophical and scientific roots.
Con frecuencia, muchos ritmos presentes en procesos fisiológicos y en el comportamiento dependen de manera decisiva de ciclos internos y su producción a través de relojes biológicos.	Many observed rhythms in physiology and behavior often crucially depend on the presence of endogenous cycles and their production through biological clocks.
Los ritmos periódicos, que no solo se tratan de reacciones a estímulos externos regulares, se han registrado en casi todos los seres vivos, incluso en bacterias, hongos, plantas y animales.	Periodic rhythms, which are not simply responses to external periodic cues, have been documented for most living beings, including bacteria, fungi, plants, and animals.
Los relojes biológicos oscilan de forma autosostenida y tienen un período de funcionamiento cíclico libre, aun si no hay estímulos externos.	Biological clocks are self sustaining oscillators which will continue a period of free-running cycling even in the absence of external cues.
Uno de los indicadores clave de que el ADN consistía en un material de tipo genético fue el experimento conducido por Hershey y Chase.	The Hershey and Chase experiment was one of the leading suggestions that DNA was a genetic material.
Hershey y Chase insertaron su propio ADN en una bacteria usando fagos, o virus.	Hershey and Chase used phages, or viruses, to implant their own DNA into a bacterium.
Realizaron dos experimentos en los que marcaron el ADN del fago con fósforo radioactivo o la proteína del ADN con azufre radioactivo.	They did two experiments marking either the DNA in the phage with a radioactive phosphorus or the protein of the phage with radioactive sulfur.
En función del tipo de mutación, de la significancia del trozo de material genético afectado y de si involucra células germinales, la mutación puede tener diversos efectos.	Mutations can have a variety of different effects depending on the type of mutation, the significance of the piece of genetic material affected and whether the cells affected are germ-line cells.
Únicamente las mutaciones en células germinales se pueden transmitir a los niños, mientras que las que ocurren en otras partes pueden causar la muerte celular o cáncer.	Only mutations in germ-line cells can be passed on to children, while mutations elsewhere can cause cell-death or cancer.
El turismo basado en la naturaleza suele atraer a gente interesada en visitar áreas naturales para disfrutar del paisaje, lo que incluye la vida silvestre animal y vegetal.	Nature-based tourism attracts people interested in visiting natural areas for the purpose of enjoying the scenery, including plant and animal wildlife.
Algunos ejemplos de posibles actividades en el lugar son: caza, pesca, fotografía, avistamiento de aves y visita a parques, y estudio de información del ecosistema.	Examples of on-site activities include hunting, fishing, photography, bird watching, and visiting parks and studying information about the ecosystem.
Un ejemplo es visitar, tomar fotografías y aprender sobre los orangutanes en Borneo.	An example is visiting, photographing, and learning about organgatuangs in Borneo.
Cada mañana, las personas abandonan pequeños pueblos en sus automóviles para ir hacia sus trabajos y suelen cruzarse con otras cuyos empleos se encuentran en el lugar del que acaban de salir.	Every morning, people leave small country towns in cars to go their workplace and are passed by others whose work destination is the place they have just left.
En esta lanzadera de traslado dinámico, todos están de algún modo conectados con un sistema de transporte basado en el uso de automóviles privados, y lo sostienen.	In this dynamic transport shuttle everyone is somehow connected with, and supporting, a transport system based on private cars.
Actualmente, los científicos sostienen que esta economía masiva del carbono ha privado a la biosfera de uno de sus estados regulares que ha contribuido con la evolución de la humanidad por los últimos dos millones de años.	Science now indicates that this massive carbon economy has dislodged the biosphere from one of its stable states that has supported human evolution for the past two million years.
