Vidal, de 28 años de edad y procedente del Sevilla, se unió al Barça hace tres temporadas.	28-year-old Vidal had joined Barça three seasons ago, from Sevilla.
Desde su mudanza a la capital catalana, Vidal jugó 49 partidos para el club.	Since moving to the Catalan-capital, Vidal had played 49 games for the club.
El récord mano a mano de Nadal contra el canadiense fue de 7-2.	Nadal's head to head record against the Canadian is 7–2.
Fue derrotado, hace poco, por Raonic en el Brisbane Open.	He recently lost against Raonic in the Brisbane Open.
En el partido, Nadal acumuló un 88% de puntos netos y ganó 76 en el primer servicio.	Nadal bagged 88% net points in the match winning 76 points in the first serve.
Después del partido, el Rey del Polvo declaró: «Estoy emocionado de estar otra vez en las rondas finales de los torneos más importantes. He venido aquí para tratar de ganar».	After the match, King of Clay said, "I am just excited about being back in the final rounds of the most important events. I am here to try to win this."
Alex Ovechkin, de Washington Capitals, es el deportista estrella del día de la fecha.	Today's Player of the Day is Alex Ovechkin of the Washington Capitals.
Marcó 2 goles y 2 asistencias en el triunfo por 5 a 3 de Washington sobre los Thrashers de Atlanta.	He had 2 goals and 2 assists in Washington's 5-3 win over the Atlanta Thrashers.
Ovechkin hizo su primera asistencia de la noche con el gol del triunfo del novato Nicklas Backstrom;	Ovechkin's first assist of the night was on the game-winning goal by rookie Nicklas Backstrom;
Su segunda anotación de la noche fue su número 60 en la temporada, convirtiéndose en el primer jugador en hacer esa cantidad o más en una misma temporada desde 1995- 96, cuando tanto Jaromir Jagr como Mario Lemieux lograron ese récord.	his second goal of the night was his 60th of the season, becoming the first player to score 60 or more goals in a season since 1995-96, when Jaromir Jagr and Mario Lemieux each reached that milestone.
Jonny Reid, copiloto del equipo de Nueva Zelanda de A1GP, hizo historia hoy al consagrarse lícitamente como el conductor más veloz sobre el puente de Auckland Harbour, de 48 años de antigüedad, en Nueva Zelanda.	Jonny Reid, co-driver for the A1GP New Zealand team, today made history by driving the fastest over the 48-year-old Auckland Harbour Bridge, New Zealand, legally.
Reid logró conducir siete veces a través del puente y superando los 160 km/h el Belleza Negra, el automóvil A1GP de Nueva Zelanda.	Mr Reid managed to drive the New Zealand's A1GP car, Black Beauty at speeds over 160km/h seven times over the bridge.
Debido a lo bajo que se encuentra Black Beauty, fue difícil para la policía de Nueva Zelanda determinar con sus radares de velocidad cuán rápido iba el Sr. Reid y en el único momento en el que pudieron medir su tiempo fue cuando desaceleró a 160 km/h.	The New Zealand police had trouble using their speed radar guns to see how fast Mr Reid was going because of how low Black Beauty is, and the only time the police managed to clock Mr Reid was when he slowed down to 160km/h.
Jarque participaba en un entrenamiento de pretemporada en Coverciano, Italia, temprano en la mañana. Se hospedaba en el hotel del equipo, antes de un encuentro programado para el domingo contra Bolonia.	Jarque was practicing during pre-season training at Coverciano in Italy earlier in the day. He was staying in the team hotel ahead of a match planned for Sunday against Bolonia.
Se quedaba en el hotel del equipo previo a un partido programado contra Bolonia para el domingo.	He was staying in the team hotel ahead of a match planned for Sunday against Bolonia.
Schumacher, quien se alejó de las pistas en 2006 después de ser siete veces campeón del Fórmula 1, debía ir en reemplazo de Felipe Massa, debido a su lesión.	Schumacher who retired in 2006 after winning the Formula 1 championship seven times, was due to replace the injured Felipe Massa.
En 2009, brasileño sufrió un traumatismo agudo en su cabeza en una colisión durante el Gran Premio de Hungría.	The Brazilian suffered a serious head injury after a crash during the 2009 Hungarian Grand Prix.
Massa debe estar fuera durante al menos lo que resta de la temporada 2009.	Massa is due to be out for at least the rest of the 2009 season.
El golf y el rugby están preparados para volver a las Olimpiadas.	Both golf and rugby are set to return to the Olympic Games.
El día de hoy, el Comité Olímpico Internacional votó en su reunión ejecutiva en Berlín para incluir los deportes. Se seleccionó al rugby, en especial el rugby union, y al golf entre otras cinco disciplinas que se habían presentado para que se considerase su participación en los Juegos Olímpicos.	The International Olympic Committee voted to include the sports at its executive board meeting in Berlin today. Rugby, specifically rugby union, and golf were selected over five other sports to be considered to participate in the Olympics.
El squash, el karate y el patinaje intentaron ingresar al programa de los Juegos Olímpicos, al igual que el béisbol y el softbol, que quedaron fuera en la competencia del 2005.	Squash, karate and roller sports tried to get onto the Olympic program as well as baseball and softball, which were voted out of the Olympic Games in 2005.
La votación todavía está sujeta a la ratificación en pleno del el COI, lo que se decidirá en la reunión de octubre, en Copenhague.	The vote must still be ratified by the full IOC at it's October meeting in Copenhagen.
No todos estuvieron a favor de la inclusión de las filas para mujeres.	Not all were supportive of the inclusion of the women’s ranks.
Amir Khan, ganador de la medalla de plata en 2004, expresó: «Muy dentro de mí, no creo que las mujeres deberían pelear. Eso es lo que opino».	2004 Olympic silver medallist Amir Khan said, "Deep down I think women shouldn’t fight. That’s my opinion."
Pese a sus declaraciones, manifestó que apoyará a los atletas británicos en los Juegos Olímpicos de Londres 2012.	Despite his comments he said he will be supporting the British competitors at the 2012 Olympics being held in London.
En enero de 2017 y con 21 años de edad, Jesús, proveniente del club brasileño Palmeiras, pasó a formar parte del Manchester City, por un salario declarado de 27 millones de libras esterlinas.	21-year-old Jesus joined Manchester City last year in January 2017 from Brazilian club Palmeiras for a reported fee of £27 million.
Desde entonces, el brasileño ha jugado para el equipo en 53 enfrentamientos, en todos los campeonatos, y ha convertido 24 veces.	Since then, the Brazilian has featured in 53 matches for the club in all competitions and has scored 24 goals.
El yudoca oriundo de Japón, Hitoshi Saito, portador de dos medallas olímpicas de oro, falleció a los 54 años.	Japanese judoka Hitoshi Saito, winner of two Olympic gold medals, has died at the age of 54.
Se comunicó que la causa del deceso fue cáncer de conductos biliares intrahepáticos.	The cause of death was announced as intrahepatic bile duct cancer.
Su deceso ocurrió el martes, en Osaka.	He died in Osaka on Tuesday.
A la fecha de su deceso, aparte de haber sido medallista olímpico y mundial, Saito era director del comité de entrenamiento de la Federación de Judo japonesa.	As well as a former Olympic and World champion, Saito was the All Japan Judo Federation training committee chairman at the time of his death.
Bobek, oriundo de Zagreb, capital de Croacia, ganó popularidad cuando se unió al Partizan de Belgrado.	Born in the Croatian capital, Zagreb, Bobek gained fame while playing for Partizan Belgrade.
En 1945 se les unió y permaneció allí hasta 1958.	He joined them in 1945 and stayed until 1958.
En su paso por el club, convirtió 403 goles en 468 partidos.	During his time with the team, he scored 403 goals in 468 appearances.
Ningún otro jugador ha hecho más apariciones o anotado más goles en favor del club que Bobek.	No one else has ever made more appearances or scored more goals for the club than Bobek.
Fue elegido como el mejor futbolista de la historia del Partizan en 1995.	In 1995 he was voted the best player in Partizan's history.
Se dio inicio a las celebraciones con un espectáculo especial en manos del globalmente famoso Cirque du Soleil.	The celebrations started with a special show by the world-renowned group Cirque du Soleil.
Luego se presentó la Orquesta Sinfónica del Estado de Estambul, un grupo de Janissary y Fatih Erkoç y Müslüm Gürses, ambos cantantes.	It was followed by the Istanbul State Symphony Orchestra, a Janissary band, and the singers Fatih Erkoç and Müslüm Gürses.
Más tarde, Whirling Derviches hizo su aparición en el escenario.	Then Whirling Dervishes took to the stage.
La diva turca Sezen Aksu cantó con Alessandro Safina, un tenor italiano, y con la cantante griega Haris Alexiou.	Turkish diva Sezen Aksu performed with the Italian tenor Alessandro Safina and Greek singer Haris Alexiou.
Para terminar, el grupo de danza turco Anatolia interpretó «Troya».	To finish, Turkish dance group Fire of Anatolia performed the show "Troy".
El barranquismo consiste en ir hasta el fondo de un cañón que esté seco o lleno de agua.	Canyoning (or: canyoneering) is about going in a bottom of a canyon, which is either dry or full of water.
Si bien el barranquismo contiene elementos tanto de la natación, como de la escalada y el salto, es un deporte que exige relativamente poco entrenamiento o estado físico para quienes se inician en él (si se lo compara, por ejemplo, con la escalada en roca, el buceo o el esquí alpino).	Canyoning combines elements from swimming, climbing and jumping--but requires relatively little training or physical shape to get started (compared to rock climbing, scuba diving or alpine skiing, for example).
El senderismo es una actividad que se practica al aire libre y que se trata de hacer caminatas por entornos naturales, con frecuencia por caminos hechos al efecto.	Hiking is an outdoor activity which consists of walking in natural environments, often on hiking trails.
Las caminatas diurnas involucran distancias de menos de una milla hasta recorridos más extensos, que pueden cubrirse en un día.	Day hiking involves distances of less than a mile up to longer distances that can be covered in a single day.
Para una caminata de un día por un sendero sencillo se necesita poca preparación y cualquier persona medianamente en forma puede hacerla.	For a day hike along an easy trail little preparations are needed, and any moderately fit person can enjoy them.
Si bien es posible que los grupos familiares con niños de corta edad requieran más preparativos, incluso con bebés e infantes en edad preescolar, es sencillo pasar un día al aire libre.	Families with small children may need more preparations, but a day outdoors is easily possible even with babies and pre-school children.
A nivel mundial, existen cerca de 200 organizaciones de turismo para corredores. La mayoría opera de manera independiente.	Internationally, there are nearly 200 running tour organizations. Most of them operate independently.
Go! Running Tours, sucesora de Global Running Tours, conecta en cuatro continentes a docenas de proveedores de visitas guiadas al trote.	The Global Running Tours successor, Go Running Tours networks dozens of sightrunning providers on four continents.
Con origen en el Running Tours Barcelona, de esa ciudad, y el Running Copenhagen, de esta otra, rápidamente se le unieron el Running Tours Prague con base en Praga y otros más.	With roots in Barcelona's Running Tours Barcelona and Copenhagen's Running Copenhagen, it was quickly joined by Running Tours Prague based in Prague and others.
USA Gymnastics respalda la nota del Comité Olímpico de los Estados Unidos y reconoce que resulta imperioso que la familia olímpica fomente un entorno seguro para todos nuestros deportistas.	USA Gymnastics supports the United States Olympic Committee's letter and accepts the absolute need of the Olympic family to promote a safe environment for all of our athletes.
Coincidimos con la declaración de la USOC de que los intereses de los atletas, los clubes y sus deportes, pueden ser atendidos más apropiadamente si se avanza con cambios significativos dentro de nuestra organización, en lugar del retiro de las certificaciones.	We agree with the USOC's statement that the interests of our athletes and clubs, and their sport, may be better served by moving forward with meaningful change within our organization, rather than decertification.
USA Gymnastics respalda a una investigación independiente que puede esclarecer de qué modo el abuso de la proporción que los sobrevivientes de Larry Nassa describieron con tanto coraje pudo haber pasado sin ser visto por tanto tiempo y acepta cualquier cambio necesario y adecuado.	USA Gymnastics supports an independent investigation that may shine light on how abuse of the proportion described so courageously by the survivors of Larry Nassar could have gone undetected for so long and embraces any necessary and appropriate changes.
La meta de USA Gymnastics y USOC es la misma: lograr que la gimnasia y otros deportes sean lo más seguro posible para que los atletas persigan sus sueños en un entorno protegido, positivo y potenciado.	USA Gymnastics and the USOC have the same goal — making the sport of gymnastics, and others, as safe as possible for athletes to follow their dreams in a safe, positive and empowered environment.
Robin Uthappa obtuvo la mayor puntuación en entradas: 70 anotaciones con solo 41 bolas, al conectar 11 cuatros y 2 seises.	Robin Uthappa made the innings highest score, 70 runs in just 41 balls by hitting 11 fours and 2 sixes.
El rendimiento tanto de Sachin Tendulkar como de Rahul Dravid, bateadores de orden medio, fue bueno y lograron una asociación de cien anotaciones.	Middle order batsmen, Sachin Tendulkar and Rahul Dravid, performed well and made a hundred-run partnership.
Mas, luego de quedar sin el wicket del capitán, India solo logró 36 carreras y 7 de sus wickets fueron derribados para finalizar las vueltas.	But, after losing the captain's wicket India only made 36 runs loosing 7 wickets to end the innings.
Con solo dieciocho medallas disponibles por día, son varios los países que no han logrado llegar al podio de las medallas.	With only eighteen medals available a day, a number of countries have failed to make the medal podium.
Están incluidos los Países Bajos, con Anna Jochemsen, quien ayer obtuvo la novena plaza en la categoría femenina en el Super-G, y Finlandia, con Katjia Saarinen en el décimo lugar en el mismo evento.	They include the Netherlands, with Anna Jochemsen finishing ninth in the women's standing class in the Super-G yesterday, and Finland with Katja Saarinen finishing tenth in the same event.
Mitchell Gourley, de Australia, obtuvo el undécimo puesto en la categoría masculina de pie del slalom súper gigante. El competidor checo, Oldrich Jelinek, terminó decimosexto en el grupo masculino de sentados.	Australia's Mitchell Gourley finished eleventh in the men's standing Super-G. Czech competitor Oldrich Jelinek finished sixteenth in the men's sitting Super-G.
Arly Velásquez, de México, obtuvo la posición número quince en el Super-G masculino sentado. Adam Hall, de Nueva Zelanda, finalizó en el puesto nueve en la categoría Super-G masculina.	Arly Velasquez of Mexico finished fifteenth in the men's sitting Super-G. New Zealand's Adam Hall finished ninth in the men's standing Super-G.
El esquiador del grupo masculino con discapacidad visual, Maciej Krezel, y su guía, Anna Ogarzynska, de Polonia, terminaron en el decimotercer lugar en el Super-G. Jong Seork Park de Corea del Sur obtuvo el vigésimo cuarto puesto en el grupo masculino sentados.	Poland's men's visually impaired skier Maciej Krezel and guide Anna Ogarzynska finished thirteenth in the Super-G. South Korea's Jong Seork Park finished twenty-fourth in the men's sitting Super-G.
Luego de que ambos tenistas mantuvieran todos los servicios del set, Murray perdió el primero por muerte súbita.	Murray lost the first set in a tie break after both men held each and every serve in the set.
Si bien Del Potro detentó una ventaja inicial en el segundo set, esto también quedó sujeto a desempate después de alcanzar el 6-6.	Del Potro had the early advantage in the second set, but this too required a tie break after reaching 6-6.
En ese momento del partido, Del Potro debió recibir tratamiento en su hombro, pero logró volver al juego.	Potro received treatment to his shoulder at this point but managed to return to the game.
Giancarlo Fisichella no logró mantener el control del vehículo y abandonó la carrera poco después de inciarse.	Giancarlo Fisichella lost control of his car and ended the race very soon after the start.
Fernando Alonso, su compañero de equipo, tuvo la delantera durante la mayor parte de la carrera, pero debió ponerle fin justo después de su parada técnica, de seguro debido a que su rueda derecha estaba seriamente doblada.	His teammate Fernando Alonso was in the lead for most of the race, but ended it right after his pit-stop, probably because a badly tucked right front wheel.
Michael Schumacher abandonó la carrera no mucho después de Alonso, a causa de una avería en la suspensión, producto de las numerosas batallas durante la carrera.	Michael Schumacher ended his race not long after Alonso, because of the suspension damage in the numerous battles during the race.
Carpanedo participó en dos carreras individuales del campeonato aparte de la competencia del miércoles.	Beyond Wednesday's event, Carpanedo competed in two individual races at the Championships.
El primero fue el slalom, en el que obtuvo un «No Terminó la primera carrera», al igual que 36 de los 116 participantes de esa carrera.	Her first was the Slalom, where she earned a Did Not Finish in her first run. 36 of the 116 competitors had the same result in that race.
En su otra carrera, el eslalon gigante, obtuvo el décimo lugar en el grupo femenino de sentadas con un tiempo de ejecución combinado de 4:41.30, 2:11.60 minutos por detrás de la primera finalista austríaca, Claudia Loesch, y 1:09.02 minutos por debajo del noveno finalista, Gyöngyi Dani, de Hungría.	Her other race, the Giant Slalom, saw her finish in tenth in the women's sitting group with a combined run time of 4:41.30, 2:11.60 minutes slower than first place finisher Austrian Claudia Loesch and 1:09.02 minutes slower than the ninth place finisher Gyöngyi Dani of Hungary.
Cuatro esquiadoras de la categoría sentadas no lograron completar sus carreras y un total de 45 participantes de 117 del Slalom Gigante no alcanzaron la clasificación en la carrera.	Four skiers in the women's sitting group failed to finish their runs, and 45 of the 117 total skiers in the Giant Slalom failed to rank in the race.
Los luchadores compañeros de Luna también le rindieron homenaje.	Fellow wrestlers also paid tribute to Luna.
Tommy Dreamer manifestó: «Luna fue la primera reina del Extremo. Falleció la noche de las dos lunas, algo único, como ella. Una mujer fuerte».	Tommy Dreamer said "Luna was the first Queen of Extreme. My first manager. Luna passed away on the night of two moons. Pretty unique just like her. Strong woman."
Dustin Oro en Polvo Runnels declaró: «Luna era tan rara como yo; hasta, incluso, más. La amo y la extrañaré. Espero que se encuentre en un lugar mejor».	Dustin "Goldust" Runnels commented that "Luna was as freaky as me...maybe even more...love her and will miss her...hopefully she's in a better place."
El ganador olímpico de la medalla de oro debía nadar en el estilo libre de 100 metros y 200 metros, y en tres relevos en los Juegos de la Commonwealth, pero su condición física ha sido puesta en dudas a raíz de sus quejas.	The Olympic gold medalist was due to swim in the 100m and 200m freestyle and in three relays at the Commonwealth Games, but due to his complaints his fitness has been in doubt.
No ha podido tomarse medicamentos para aliviar el dolor, porque está prohibido su uso en los Juegos.	He has been unable to take the drugs needed to overcome his pain as they are banned from the Games.
No se implementará transporte adicional y los trenes no se detendrán en Wembley. El estacionamiento para automóviles y el disuasorio no estarán disponibles.	No extra transport is being put on and overground trains will not stop at Wembley, and car parking and park-and-ride facilities are unavailable at the ground.
Debido a la preocupación generada por la posible falta de transporte, se consideró la posibilidad de que el juego se realizara a puertas cerradas, sin los fanáticos del equipo.	Fears of lack of transportation raised the possibility that the game would be forced to play behind closed doors without the team's supporters.
Los estribos son los soportes para los pies de los jinetes que cuelgan a ambos lados de la silla de montar.	Stirrups are supports for the rider's feet that hang down on either side of the saddle.
Si bien proporcionan mayor estabilidad al jinete, pueden presentar problemas de seguridad, ya que es posible que sus pies se atasquen en ellos.	They provide greater stability for the rider but can have safety concerns due to the potential for a rider's feet to get stuck in them.
Si un jinete es despedido del caballo, pero le queda un pie atorado en el estribo, puede ser arrastrado si el animal huye. Para reducir el riesgo, existe una serie de recaudos de seguridad.	If a rider is thrown from a horse but has a foot caught in the stirrup, they could be dragged if the horse runs away. To minimize this risk, a number of safety precautions can be taken.
En primer lugar, la mayoría de los jinetes usan botas de montar con taco que tiene una suela lista y bastante estrecha.	First, most riders wear riding boots with a heel and a smooth, quite narrow, sole.
Además, existen monturas, en especial las inglesas, con barras de seguridad que permiten que el cuero del estribo se desprenda de su estructura si un jinete que sale despedido tira hacia atrás.	Next, some saddles, particularly English saddles, have safety bars that allow a stirrup leather to fall off the saddle if pulled backwards by a falling rider.
El Valle de Cochamó es el destino para escalar más popular de Chile y es conocido como el Yosemite de Sudamérica, con variedad de extensos muros y riscos de granito.	Cochamó Valley - Chile's premier climbing destination, known as the Yosemite of South America, with a variety of granite big walls and crags.
Las cumbres también ofrecen vistas impactantes desde los picos. Escaladores de todos los rincones del globo constantemente delimitan nuevos caminos entre sus muros de potencial infinito.	Summits include breath-taking views from peaks. Climbers from all parts of the world are continually establishing new routes amongst its endless potential of walls.
Los deportes de nieve en descenso, como el esquí y la tablanieve, son disciplinas populares que consisten en deslizarse con esquís o una tabla fijada a los pies, sobre un terreno nevado.	Downhill snowsports, which include skiing and snowboarding, are popular sports involving sliding down snow-covered terrain with skis or a snowboard attached to your feet.
Esquiar es una actividad principal de viaje con muchos adeptos, en ocasiones llamados «amantes del esquí», que organizan sus vacaciones completamente en base al esquí en un sitio específico.	Skiing is a major travelling activity with many enthusiasts, occasionally known as "ski bums," planning entire vacations around skiing at a particular location.
La idea del esquí es muy antigua, ya que hay pinturas rupestres que representan esquiadores y que se remontan alrededor del 5.000 a.C.	The idea of skiing is very old — cave paintings depicting skiers date back as far as 5000 BC!
Como disciplina, el esquí alpino data de no después del siglo XVII. En 1861 los noruegos inauguraron el primer club recreativo de esquí en Australia.	Downhill skiing as a sport goes back to at least the 17th century, and in 1861 the first recreational ski club was opened by Norwegians in Australia.
Mochilero en esquí: también conocido como esquí de zona rural, de travesía o senderismo en esquí.	Backpacking by ski: This activity is also called backcountry ski, ski touring or ski hiking.
Si bien vinculan, en general no conlleva practicar el esquí de travesía o el montañismo de estilo alpino, desarrollados en suelos de pendiente pronunciada y con esquís y calzado mucho más rígidos.	It is related to but usually not involving alpine style ski touring or mountaineering, the latter ones done in steep terrain and requiring much stiffer skis and boots.
Imagínese la pista de esquí como una ruta de senderismo.	Think of the skiing route as of a similar hiking route.
En condiciones satisfactorias, logrará recorrer distancias un poco más largas que si lo hace a pie, pero muy rara vez alcanzará la velocidad del esquí a campo traviesa sin una mochila de buen peso en pistas acondicionadas.	In good conditions you will be able to cover somewhat greater distances than walking – but only very seldom you will get the speeds of cross country skiing without a heavy backpack in groomed tracks.
