Le JAS 39C Gripen s’est écrasé sur une piste autour de 9 h 30 heure locale (0230 UTC) et a explosé, provoquant la fermeture de l’aéroport aux vols commerciaux.	The JAS 39C Gripen crashed onto a runway at around 9:30 am local time (0230 UTC) and exploded, closing the airport to commercial flights.
Le pilote a été identifié comme étant le chef d’escadron Dilokrit Pattavee.	The pilot was identified as Squadron Leader Dilokrit Pattavee.
La presse locale a rapporté qu'un véhicule de lutte contre l'incendie de l'aéroport a fait des tonneaux en portant secours.	Local media reports an airport fire vehicle rolled over while responding.
À 8 h 46 exactement, un silence s’est abattu sur la ville, marquant le moment exact où le premier jet a atteint sa cible.	At exactly 8:46 a.m. a hush fell across the city, marking the exact moment the first jet struck its target.
Deux faisceaux de lumière ont été montés pour pointer vers le ciel pendant la nuit.	Two beams of light have been rigged up to point skywards overnight.
La construction de cinq nouveaux gratte-ciels est en cours sur le site, dont un centre de transport et un parc commémoratif au milieu.	Construction is ongoing for five new skyscrapers at the site, with a transportation center and memorial park in the middle.
La marine américaine a également déclaré qu'elle enquêtait sur l'incident.	The US Navy also said they were investigating the incident.
Ils ont également affirmé dans une déclaration : « L'équipage travaille actuellement à déterminer le meilleur moyen d'extraire le navire en toute sécurité ».	They also said in a statement, "The crew is currently working to determine the best method of safely extracting the ship".
Un navire de contre-mesures anti-mines de classe Avenger, le navire était en route pour Puerto Princesa à Palawan.	An Avenger class mine countermeasures ship, the ship was on its way to Puerto Princesa in Palawan.
Il est affecté à la septième flotte de la marine américaine et basé à Sasebo, Nagasaki, au Japon.	It is assigned to the U.S. Navy’s Seventh Fleet and based in Sasebo, Nagasaki in Japan.
Par chance, il ne m'est rien arrivé, mais j'ai assisté à une scène macabre, où des gens essayaient de briser des vitres afin de sortir.	"Luckily nothing happened to me, but I saw a macabre scene, as people tried to break windows in order to get out.
Les gens frappaient les vitres avec des chaises, mais les fenêtres étaient incassables.	People were hitting the panes with chairs, but the windows were unbreakable.
« Une des vitres s'est finalement brisée, et ils ont commencé à sortir par la fenêtre », a déclaré Franciszek Kowal, un survivant.	One of the panes finally broke, and they started to get out by the window," said survivor Franciszek Kowal.
Suite à l’accident, Gibson a été transporté à l’hôpital, mais a succombé immédiatement après.	After the accident occurred, Gibson was transported to a hospital but died shortly afterwards.
Le chauffeur du camion, âgé de 64 ans, n’a pas été blessé dans l’accident.	The truck driver, who is aged 64, was not injured in the crash.
Le véhicule lui-même a été enlevé du lieu de l'accident vers 12 h 00 GMT le même jour.	The vehicle itself was taken away from the scene of the accident at approximately 1200 GMT on the same day.
Un employé d'un garage proche du lieu de l’accident a déclaré : « il y avait des enfants qui cherchaient à traverser la route, et qui criaient et pleuraient. »	A person working in a garage near where the accident occurred said: "There were children waiting to cross the road and they were all screaming and crying."
Ils sont tous revenus en courant de l’endroit où l’accident s’était produit.	They all ran back from where the accident had happened.
Bien que trois personnes aient été présentes dans la maison quand la voiture l'a percutée, aucune n'a été blessée.	Although three people were inside the house when the car impacted it, none of them were hurt.
Cependant, le conducteur a été grièvement blessé à la tête.	However, the driver sustained serious injuries to the head.
La voie où l'accident a eu lieu a été temporairement barrée pour permettre aux services de secours d'extraire le conducteur de l'Audi TT rouge.	The road where the crash happened was temporarily closed while emergency services freed the driver from the red Audi TT.
Il a d'abord été hospitalisé à l'hôpital James Paget de Great Yarmouth.	He was initially hospitalised in the James Paget Hospital in Great Yarmouth.
Il a ensuite été transféré au centre hospitalier Addenbrooke's Hospital de Cambridge.	He was subsequently relocated to Addenbrooke's Hospital in Cambridge.
