Comme la capacité à acquérir la connaissance et à apprendre a changé d'une certaine façon telle que mentionnée ci-dessus, le rythme de base auquel la connaissance s'acquérait a changé.	As the ability to obtain knowledge and to learn changed in such a way as mentioned above the base rate at which knowledge was obtained changed.
La manière de récupérer l'information était différente. Il n'y avait plus de pression sur la mémoire individuelle, mais la capacité à se souvenir d'un texte devenait plus importante.	The approach to obtaining information was different. No longer did pressure reside within individual recall, but the ability to recall text became more of a focus.
En somme, la Renaissance a été à l'origine d'un changement majeur dans la façon d'envisager l'apprentissage et la diffusion des connaissances.	In essence, the Renaissance made a significant change in the approach to learning and the dissemination of knowledge.
Les entreprises de médias mentent couramment sur l'objectif de cette mesure, prétendant qu'elle vise à « empêcher le piratage ».	The media companies routinely lie about the purpose of this, claiming that it is to "prevent piracy".
En fait, les codes régionaux n'ont absolument aucun effet sur la copie illégale; une copie bit à bit d'un disque fonctionne très bien sur n'importe quel appareil où l'original peut être joué.	In fact, region codes have absolutely no effect on illegal copying; a bit-for-bit copy of a disk will play just fine on any device where the original will.
Le but réel est de donner à ces entreprises un plus grand contrôle sur leurs marchés ; il s’agit de gagner de l’argent.	The actual purpose is to give those companies more control over their markets; it's all about money spinning.
Les appels étant acheminés par l'internet, vous n'avez pas besoin d'utiliser une compagnie de téléphone située où vous vivez ou où vous voyagez.	Because calls are routed over the Internet, you do not need to use a phone company located where you live or where you travel.
Il n’est pas non plus obligatoire d’obtenir un numéro local de la collectivité dans laquelle vous vivez; vous pouvez obtenir une connexion Internet par satellite dans les contrées sauvages de Chicken, en Alaska, et sélectionner un numéro qui indique que vous êtes dans l’Arizona ensoleillée.	There is also no requirement that you obtain a local number from the community in which you live; you can obtain a satellite Internet connection in the wilds of Chicken, Alaska and select a number which claims you're in sunny Arizona.
Souvent, il vous faut acheter un numéro international qui autorise les appels en RCTP. L'endroit où votre numéro de téléphone est localisé est déterminant pour les personnes qui vous appellent.	Often, you have to buy a global number separately that allows PSTN phones to call you. Where the number is from makes a difference for people calling you.
Les applications de traduction en temps réel sont des applis capable de traduire automatiquement des segments entiers de texte, ceci d'une langue vers une autre.	Real-time text translator apps – applications that are capable of automatically translating whole segments of text from one language into another.
Certaines des applications de cette catégorie peuvent même traduire des textes en langue étrangère inscrits sur des panneaux ou d'autres objets du quotidien lorsque l'utilisateur pointe son smartphone vers eux.	Some of the applications in this category can even translate texts in foreign languages on signs or other objects in the real world when the user points the smartphone towards those objects.
Les moteurs de traduction se sont considérablement améliorés, et donnent maintenant souvent des traductions plus ou moins correctes (et plus rarement du charabia), mais il faut faire attention, car ils ont peut-être encore tout faux.	The translation engines have improved dramatically, and now often give more or less correct translations (and more seldom gibberish), but some care is due, as they still may have gotten it all wrong.
L'une des applications les plus réputées dans cette catégorie est Google Translate, qui permet de traduire hors ligne après avoir téléchargé les données linguistiques souhaitées.	One of the most prominent apps in this category is Google Translate, which allows offline translation after downloading the desired language data.
L'utilisation d'applications de navigation par GPS sur votre smartphone peut être le moyen le plus simple et le plus pratique pour vos déplacements en dehors de votre pays de résidence.	Using GPS navigation apps on your smartphone can be the easiest and most convenient way to navigate when out of your home country.
Il peut permettre d’économiser de l’argent en achetant de nouvelles cartes pour un GPS ou un appareil GPS autonome, ou bien en en louant un auprès d’une société de location de voitures.	It can save money over buying new maps for a GPS, or a standalone GPS device or renting one from a car rental company.
Si vous n’avez pas de connexion de données sur votre téléphone, ou s’il est hors de portée, ses performances peuvent être limitées ou indisponibles.	If you don't have a data connection for your phone, or when it is out of range, their performance can be limited or unavailable.
Chaque magasin du coin est rempli d'une panoplie déroutante de cartes téléphoniques prépayées qui peuvent être utilisées à partir de téléphones payants ou de téléphones ordinaires.	Every corner store is filled with a confusing array of pre-paid phone cards that can be used from pay phones or ordinary telephones.
Si la plupart des cartes permettent d'appeler partout, certaines sont spécialisées dans l'offre de tarifs avantageux pour des groupes de pays spécifiques.	While most cards are good for calling anywhere, some specialise in providing favourable call rates to specific groups of countries.
L’accès à ces services se fait souvent par le biais d’un numéro de téléphone gratuit qui peut être appelé sans frais depuis presque tous les téléphones.	Access to these services is often through a toll-free telephone number that can be called from most phones without charge.
Internet allie des éléments de communication de masse et de communication interpersonnelle.	The Internet combines elements of both mass and interpersonal communication.
Les caractéristiques distinctes d'Internet conduisent à des dimensions supplémentaires en termes d'approche des usages et des gratifications.	The distinct characteristics of the Internet lead to additional dimensions in terms of the uses and gratifications approach.
Par exemple, « l'apprentissage » et « la socialisation » sont considérés comme de grands facteurs favorisant l'utilisation d'Internet (James et al., 1995).	For example, “learning” and “socialization” are suggested as important motivations for Internet use (James et al., 1995).
« L’implication personnelle » et « les relations continues » ont également été identifiées comme étant de nouveaux aspects motivationnels par Eighmey et McCord (1998) lorsqu’ils ont étudié les réactions du public vis-à-vis des sites internet.	“Personal involvement” and “continuing relationships” were also identified as new motivation aspects by Eighmey and McCord (1998) when they investigated audience reactions to websites.
L'usage de l'enregistrement vidéo a mené à de grandes découvertes dans l'interprétation des micro-expressions, c'est-à-dire des expressions faciales durant quelques millisecondes.	The use of video recording has led to important discoveries in the interpretation of micro-expressions, facial movements which last a few milliseconds.
On prétend notamment que l’on peut détecter si une personne ment en interprétant correctement des micro-expressions.	In particular, it is claimed that one can detect whether a person is lying by interpreting micro-expressions correctly.
Oliver Sacks, dans son article Le discours du président, a indiqué comment les personnes ne pouvant pas comprendre le discours en raison de lésions cérébrales sont néanmoins en mesure d’évaluer la sincérité avec précision.	Oliver Sacks, in his paper The President's Speech, indicated how people who are unable to understand speech because of brain damage are nevertheless able to assess sincerity accurately.
Il suggère même que de telles capacités d’interprétation du comportement humain peuvent se trouver chez des animaux tels que les chiens domestiques.	He even suggests that such abilities in interpreting human behavior may be shared by animals such as domestic dogs.
Dans les endroits reculés, sans réseau de téléphonie cellulaire, vous n'aurez peut-être pas d'autre choix que de recourir à la téléphonie par satellite.	In remote locations, without cell phone coverage, a satellite phone may be your only option.
Un téléphone satellite ne remplace généralement pas un téléphone portable, car il faut être à l'extérieur et avoir une vue dégagée sur le satellite pour passer un appel.	A satellite phone is not generally a replacement for a mobile phone, as you have to be outdoors with clear line of sight to the satellite to make a phone call.
C'est un service souvent utilisé par la navigation, y compris les embarcations de plaisance, ainsi que par les expéditions qui ont des besoins de transmission de données à distance et de téléphonie.	The service is frequently used by shipping, including pleasure craft, as well as expeditions who have remote data and voice needs.
Votre opérateur téléphonique local devrait pouvoir vous en dire plus au sujet de la connexion à ce service.	Your local telephone service provider should be able to give more information about connecting to this service.
