Le 24 septembre 1759, Arthur Guinness a signé un bail de 9 000 ans pour la brasserie St James' Gate à Dublin en Irlande.	On September 24, 1759, Arthur Guinness signed a 9,000 year lease for the St James' Gate Brewery in Dublin, Ireland.
250 ans plus tard, Guinness est devenue une entreprise mondiale qui réalise chaque année un chiffre d'affaires de plus de 10 milliards d'euros (14,7 milliards de dollars US).	250 years later, Guinness has grown to a global business that turns over 10 billion euros (US$14.7 billion) every year.
L'éditeur de jeux Konami a déclaré aujourd'hui dans un journal japonais qu'il ne lancera pas le jeu Six Days in Fallujah.	The game publisher Konami stated today in a Japanese newspaper that they will not be releasing the game Six Days in Fallujah.
Le jeu est basé sur la deuxième bataille de Falloujah, une bataille vicieuse entre les forces américaines et irakiennes.	The game is based on the Second Battle of Fallujah, a vicious battle between American and Iraqi forces.
Alors qu'ils patientaient sous une chaleur de 32 ° C, les passagers se sont vu offrir des bouteilles d'eau.	Passengers were given water as they waited in 90(F)-degree heat.
Le capitaine des pompiers Scott Kouns a déclaré : « C’était une journée chaude dans le comté de Santa Clara avec des températures dépassant 90 °F.	Fire captain Scott Kouns said, "It was a hot day in the Santa Clara with temperatures in the 90s.
Chaque minute passée emprisonné sur des montagnes russes doit être pour le moins désagréable, et il a fallu au moins une heure pour extraire la première personne du manège. »	Any length of time trapped on a roller coaster would be uncomfortable, to say the least, and it took at least an hour to get the first person off the ride."
En 1956, Słania s'est installé en Suède, où trois ans plus tard, il a commencé à travailler pour la poste suédoise pour en devenir le graveur en chef.	In 1956 Słania moved to Sweden, where three years later he began work for the Swedish Post Office and became their chief engraver.
Il a produit plus de 1000 timbres pour la Suède et 28 autres pays.	He produced over 1,000 stamps for Sweden and 28 other countries.
Son travail est d'une telle qualité et d'un tel niveau de détail qu'il est l'un des rares philatélistes bien connus du « grand public ». Certains collectionneurs consacrent leur attention uniquement à ses œuvres.	His work is of such recognized quality and detail that he is one of the very few "household names" among philatelists. Some specialize in collecting his work alone.
Son millième timbre a été le magnifique « Great Deeds by Swedish Kings » de David Klöcker Ehrenstrahl en 2000, qui figure dans le Livre Guinness des records.	His 1,000th stamp was the magnificent "Great Deeds by Swedish Kings" by David Klöcker Ehrenstrahl in 2000, which is listed in the Guinness Book of World Records.
Il a également gravé des billets de banque pour de nombreux pays. Parmi les exemples récents de son travail, on peut citer les portraits du Premier ministre au recto des nouveaux billets canadiens de 5 et 100 dollars.	He was also engaged in engraving banknotes for many countries, recent examples of his work including the Prime Ministerial portraits on the front of the new Canadian $5 and $100 bills.
Le groupe Aerosmith a annulé les derniers concerts de sa tournée.	Aerosmith have cancelled their remaining concerts on their tour.
Le groupe de rock devait faire une tournée aux États-Unis et au Canada jusqu'au 16 septembre.	The rock band was due to tour the United States and Canada until September 16.
Ils ont annulé la tournée après que le chanteur Steven Tyler se soit blessé en tombant de scène lors d'un concert le 5 août dernier.	They have cancelled the tour after lead singer Steven Tyler was injured after he fell off stage while performing on August 5.
Le programme a démarré à 20 h 30, heure locale (15 h 00 UTC).	The program started at 8:30 p.m. local time (15.00 UTC).
Des chanteurs célèbres dans tout le pays ont présenté des bhajans, ou chants de dévotion, aux pieds de Shri Shyam.	Famous singers across the country presented bhajans, or devotional songs, to Shri Shyam's feet.
La chanteuse Sanju Sharma a commencé la soirée, suivie par Jai Shankar Choudhary. Lakkha Singh a également présenté le bhajan de Chhappan Bhog. Le chanteur Raju Khandelwal l’accompagnait.	Singer Sanju Sharma started the evening, followed by Jai Shankar Choudhary. esented the chhappan bhog bhajan as well. Singer, Raju Khandelwal was accompanying him.
Ensuite, Lakkha Singh a pris l'initiative de chanter les bhajans.	Then, Lakkha Singh took the lead in singing the bhajans.
108 assiettes de Chhappan Bhog (dans l'hindouisme, 56 aliments comestibles différents, comme des sucreries, des fruits, des noix, des plats etc. qui sont offerts à la divinité) ont été servis à Baba Shyam.	108 plates of Chhappan Bhog (in Hinduism, 56 different edible items, like, sweets, fruits, nuts, dishes etc. which are offered to deity) were served to Baba Shyam.
Quant à Lakkha Singh, il a lui aussi présenté le chhappan bhog bhajan, tout en étant accompagné du chanteur Raju Khandelwal.	Lakkha Singh presented the chhappan bhog bhajan as well. Singer, Raju Khandelwal was accompanying him.
