Le bus se dirigeait vers le parc de Six Flags St. Louis, dans le Missouri, pour que le groupe joue devant une salle comble.	The bus was headed to Six Flags St. Louis in Missouri for the band to play to a sold-out crowd.
Selon les témoins, samedi à 1 h 15 du matin, le bus franchissait une ligne verte quand la voiture s’est retournée devant lui.	At 1:15 a.m. Saturday, according to witnesses, the bus was going through a green light when the car made a turn in front of it.
Comme la nuit du 9 août, l'œil du Mokarot était à environ 17 km de la province chinoise de Fujian.	As of the night of August 9, the eye of Morakot was about seventy kilometres away from the Chinese province of Fujian.
On estime que le typhon se dirige vers la Chine à une vitesse de 11 km/h.	The typhoon is estimated to be moving toward China at eleven kph.
Le Twin Otter avait essayé d'atterrir à Kokoda hier sous le nom de vol Airlines PNG CG4684, mais avait déjà échoué une fois.	The Twin Otter had been trying to land at Kokoda yesterday as Airlines PNG Flight CG4684, but had aborted once already.
Environ dix minutes avant de devoir atterrir, il a disparu lors de sa deuxième tentative d’approche.	About ten minutes before it was due to land from its second approach it disapeared.
Le lieu du crash, identifié ce jour, est si difficile d'accès qu'il a fallu déposer deux policiers dans la jungle afin qu'ils atteignent le site à la recherche d'éventuels survivants.	The crash site was located today and is so inaccessable that two policemen were dropped into the jungle in order to hike to the scene and seek survivors.
Les recherches avaient été entravées par le même mauvais temps qui avait entraîné l'atterrissage avorté.	The search had been hampered by the same bad weather that had caused the aborted landing.
Selon les rapports, un appartement de la rue Macbeth a explosé à cause d'une fuite de gaz.	According to reports, an apartment on Macbeth Street exploded due to a gas leak.
Un agent de la compagnie de gaz s'est rendu sur les lieux après qu'un voisin ait appelé au sujet d'une fuite de gaz.	An official with the gas company was reporting to the scene after a neighbor called about a gas leak.
Une fois l'agent arrivé sur place, l'appartement a explosé.	When the official arrived, the apartment exploded.
Aucun blessé grave n’a été signalé, mais au moins cinq personnes présentes sur les lieux au moment de l’explosion ont été traitées pour des symptômes d’état de choc.	No major injuries were reported, but at least five people on scene at the time of the explosion were treated for symptoms of shock.
Personne n'était à l'intérieur de l'appartement.	No one was inside the apartment.
A l'époque, près de 100 habitants ont été évacués de la zone.	At the time, nearly 100 residents were evacuated from the area.
Au moins 100 personnes avaient assisté à la fête, afin de célébrer le premier anniversaire d'un couple dont le mariage s'est tenu l'an passé.	At least 100 people had attended the party, in order to celebrate the first anniversary of a couple whose wedding was held last year.
Les autorité ont déclaré qu'une cérémonie anniversaire officielle avait été prévue à une date ultérieure.	A formal anniversary event was scheduled for a later date, officials said.
Le couple s'était marié au Texas il y a un an et était venu à Buffalo pour fêter l'occasion avec des amis et des parents.	The couple had married in Texas one year ago and came to Buffalo to celebrate with friends and relatives.
Le mari, âgé de 30 ans et natif de Buffalo, faisait partie des quatre victimes de la tuerie, mais sa femme n'a pas été blessée.	The 30-year-old husband, who was born in Buffalo, was one of the four killed in the shooting, but his wife was not hurt.
La tempête tropicale Danielle, quatrième tempête nommée de la saison des ouragans atlantiques 2010, s'est formée dans l'est de l'océan Atlantique.	Tropical Storm Danielle, fourth named storm of the 2010 Atlantic hurricane season, has formed in the eastern Atlantic Ocean.
La vitesse maximale des vents soutenus de cette tempête, qui se produit à environ 4 800 km de Miami, en Floride, atteint 64 km/h.	The storm, located approximately 3,000 miles from Miami, Florida, has maximum sustained winds of 40 mph (64 kph).
Les scientifiques du Centre national des ouragans prévoient que Danielle se transformera en ouragan d’ici mercredi.	Scientists at the National Hurricane Center predict that Danielle will strengthen to a hurricane by Wednesday.
Comme la tempête est loin d'atteindre les côtes, il reste difficile d'évaluer son impact potentiel sur les États-Unis ou les Caraïbes.	As the storm is far from landfall, it remains difficult to assess potential impact to the United States or Caribbean.
Peter Lenz, un pilote de moto de 13 ans, est mort après avoir été impliqué dans un accident sur l'Indianapolis Motor Speedway.	Peter Lenz, a 13-year-old motorcycle racer, has died after being involved in a crash at the Indianapolis Motor Speedway.
Pendant le tour d'échauffement, Lenz est tombé de sa moto, puis a été heurté par son compagnon de course Xavier Zayat.	While on his warm-up lap, Lenz fell off his bike, and was then struck by fellow racer Xavier Zayat.
Il a été immédiatement pris en charge par le personnel médical sur la piste et transporté dans un hôpital local où il est mort par la suite.	He was immediately attended to by the on-track medical staff and transported to a local hospital where he later died.
Zayat est sorti indemne de l'accident.	Zayat was unhurt in the accident.
D'après le dernier bulletin, les relevés du niveau de la mer indiquent qu'un tsunami s'est produit. Une activité tsunami précise a été enregistrée près de Pago Pago et de Niue.	According to the latest bulletin, sea level readings indicated a tsunami was generated. There was some definite tsunami activity recorded near Pago Pago and Niue.
Aucun dommage ou blessure grave n’a été signalé à Tonga, mais l’électricité a été temporairement coupée, ce qui aurait empêché les autorités tonganes de recevoir l’alerte au tsunami émise par le centre d’alerte des tsunamis dans le Pacifique.	No major damage or injuries have been reported in Tonga, but power was temporarily lost, which reportedly prevented Tongan authorities from receiving the tsunami warning issued by the PTWC.
Quatorze écoles d’Hawaii situées sur ou près des côtes ont été fermées toute la journée de mercredi malgré la levée des alertes.	Fourteen schools in Hawaii located on or near coastlines were closed all of Wednesday despite the warnings being lifted.
Les accidents aériens sont fréquents en Iran, qui dispose d'une flotte vieillissante et mal entretenue autant pour les vols civils que militaires.	Air accidents are common in Iran, which has an aging fleet that is poorly maintained both for civil and military operations.
En raison des sanctions internationales, il n'est pas possible d'acheter de nouveaux avions.	International sanctions have meant that new aircraft cannot be purchased.
Au début de cette semaine, l'accident d'un hélicoptère de la police a tué trois personnes et en a blessé trois autres.	Earlier this week, a police helicopter crash killed three people and wounded three more.
Le mois dernier, l'Iran a connu sa pire catastrophe aérienne depuis des années lorsqu'un avion de ligne se dirigeant vers l'Arménie s'est écrasé, tuant les 168 personnes à bord.	Last month Iran saw its worst air disaster in years when an airliner heading to Armenia crashed, killing the 168 on board.
Le même mois, un autre avion de ligne a fait une sortie de piste à Mashhad et a heurté un mur, tuant ainsi dix-sept personnes.	The same month saw another airliner overrun a runway at Mashhad and strike a wall, killing seventeen.
Le tremblement de terre a frappé les Mariannes à 7 h 19 heure locale (21 h 19 GMT vendredi).	The eathquake struck Mariana at 07:19 a.m. local time (09:19 p.m. GMT Friday).
Le Bureau de gestion des urgences des îles Mariannes du Nord a déclaré qu'aucun dégât n'avait été signalé dans ce pays.	The Northern Marianas emergency management office said that there were no damages reported in the nation.
De plus, le Centre d'alerte des tsunamis dans le Pacifique a déclaré qu'il n'y avait aucun signe de tsunami.	Also the Pacific Tsunami Warning Center said that there was no Tsunami indication.
L'agence Xinhua a rapporté que les enquêteurs du gouvernement ont récupéré deux enregistreurs de vol (ou « boîtes noires ») mercredi.	Xinhua reported that government investigators recovered two 'black box' flight recorders on Wednesday.
