La lame d'un patin à glace moderne est dotée de deux extrémités avec un creux concave situé entre les deux. Ces deux extrémités permettent une meilleure adhérence à la glace, même lorsqu'elles sont inclinées.	The blade on a modern ice skate has a double edge with a concave hollow between them. The two edges allow for a better grasp of the ice, even when tilted.
Comme le bas de la lame est légèrement incurvé, lorsque la lame s'incline d'un côté ou de l'autre, le bord qui est en contact avec la glace s'incurve également.	Because the bottom of the blade is slightly curved, as the blade tilts to one side or the other, the edge which is in contact with the ice also curves.
Cela fait tourner le patineur. Si les patins penchent vers la droite, le patineur tourne à droite, si les patins penchent vers la gauche, le patineur tourne à gauche.	This causes the skater to turn. If the skates tilt to the right, the skater turns right, if the skates tilt to the left, the skater turns left.
Pour retourner au niveau d'énergie précédent, il leur faut se débarrasser de l'excès d'énergie emmagasiné au contact de la lumière.	To return to their previous energy level, they must get rid of the extra energy they got from the light.
Ils le font en émettant une minuscule particule de lumière appelée « photon ».	They do this by emitting a tiny particle of light called a "photon".
Les scientifiques appellent ce processus « émission stimulée de rayonnement », car les atomes sont stimulés par la lumière vive, ce qui provoque l’émission d’un photon de lumière (la lumière étant un type de rayonnement).	Scientists call this process "stimulated emission of radiation" because the atoms are stimulated by the bright light, causing the emission of a photon of light, and light is a type of radiation.
L'image suivante montre les atomes qui émettent des photons. Bien entendu en réalité les photons sont bien plus petits que ceux représentés sur l'image.	The next picture shows the atoms emitting photons. Of course, in reality photons are a lot smaller than those in the picture.
Les photons sont même plus petits que les particules formant les atomes !	Photons are even smaller than the stuff that makes up atoms!
Après des centaines d'heures de fonctionnement, le filament dans l'ampoule finit par brûler et l'ampoule électrique ne marche plus.	After hundreds of hours of operation the filament in the bulb eventually burns out and the light bulb no longer works.
L'ampoule doit alors être remplacée. Il faut être prudent lors du changement de l'ampoule.	The light bulb then needs replacing. It is necessary to be careful in replacing the light bulb.
Tout d’abord, l’interrupteur de l’appareil d’éclairage doit être éteint ou le câble débranché.	First, the switch for the light fixture needs to be turned off or the cable disconnected.
Cela est dû au fait que le courant électrique qui circule dans la douille, où s'encastre la partie métallique de l'ampoule, peut entraîner des chocs électriques graves si vous entrez en contact avec son intérieur ou sa base métallique alors que l'ampoule est encore partiellement insérée dans la douille.	This is because electricity flowing into the socket where the metallic part of bulb sits can give you a severe electric shock if you touch the inside of the socket or the metal base of the bulb while it is still partly in the socket.
Le temps est quelque chose qui nous entoure et qui affecte tout ce que nous faisons, et pourtant il est difficile à comprendre.	Time is something that is all around us, and affects everything we do, yet is difficult to understand.
Le temps a été étudié par des érudits religieux, philosophiques et scientifiques pendant des milliers d'années.	Time has been studied by religious, philosophical, and scientific scholars for thousands of years.
Nous vivons le temps comme une série d'événements qui passent du futur au passé en passant par le présent.	We experience time as a series of events passing from the future through the present to the past.
Le temps est également un moyen de comparer la durée (longueur) des événements.	Time is also how we compare the duration (length) of events.
Vous pouvez marquer le temps qui passe vous-même en observant la répétition d'un événement cyclique. Un événement cyclique est quelque chose qui se reproduit régulièrement.	You can mark the passing of time yourself by observing the repetition of a cyclical event. A cyclical event is something that happens again and again regularly.
De nos jours, les ordinateurs sont utilisés pour modifier des photos et des vidéos.	Computers today are used to manipulate pictures and videos.
Les ordinateurs peuvent générer des animations complexes, de plus en plus utilisées à la télévision et au cinéma.	Sophisticated animations can be constructed on computers, and this kind of animation is increasingly being used in television and films.
On enregistre souvent la musique avec des ordinateurs sophistiqués qui permettent de transformer et mixer des sons ensemble.	Music is often recorded using sophisticated computers to process and mix sounds together.
Les villes de Harappa et Mohenjo-daro avaient des toilettes équipées d’une chasse d’eau dans presque toutes les maisons, reliées à un système d’égouts sophistiqué.	The cities of Harappa and Mohenjo-daro had a flush toilet in almost every house, attached to a sophisticated sewage system.
Des restes de systèmes d'égouts ont été trouvés dans les maisons des villes minoennes de Crète et de Santorin en Grèce.	Remains of sewage systems have been found in the houses of the Minoan cities of Crete and Santorini in Greece.
Il y avait également des toilettes dans l'Égypte ancienne, en Perse et en Chine. Dans la civilisation romaine, les toilettes faisaient parfois partie des bains publics où hommes et femmes se côtoyaient.	There were also toilets in ancient Egypt, Persia and China. In Roman civilization, toilets were sometimes part of public bath houses where men and women were together in mixed company.
Lorsque vous appelez une personne qui se trouve à des milliers de kilomètres, vous utilisez un satellite.	When you call someone who is thousands of miles away, you are using a satellite.
Le satellite reçoit l'appel dans l'espace puis le renvoie sur Terre, presque instantanément.	The satellite in space gets the call and then reflects it back down, almost instantly.
Le satellite a été envoyé dans l'espace par une fusée. Les scientifiques utilisent des télescopes dans l'espace parce que l'atmosphère terrestre déforme une partie de notre lumière et de notre vision.	The satellite was sent into space by a rocket. Scientists use telescopes in space because the Earth’s atmosphere distorts some of our light and view.
Il faut une fusée géante de plus de 30 mètres de haut pour mettre un satellite ou un télescope dans l’espace.	It takes a giant rocket over a 100 feet high to put a satellite or telescope in space.
La roue a changé le monde de bien des manières. Le plus grand avantage qu'elle nous ait apporté est d'avoir rendu les transports beaucoup plus simples et rapides.	The wheel has changed the world in incredible ways. The biggest thing that the wheel has done for us is given us much easier and faster transportation.
Cela nous a apporté le train, la voiture et de nombreux autres moyens de transport.	It has brought us the train, the car, and many other transportation devices.
Le symbole « pousser » ressemble à un V et le symbole « tirer » à une agrafe ou à un carré dont le côté inférieur est manquant.	The "up bow" mark looks like a V and the "down bow mark" like a staple or a square missing its bottom side.
Le haut signifie que vous devez commencer par la pointe et pousser l’archet, et le bas signifie que vous devez commencer par la hausse (qui est l’endroit où votre main tient l’arc) et tirer l’archet.	Up means you should start at the tip and push the bow, and down means you should start at the frog (which is where your hand is holding the bow) and pull the bow.
Un archet vers le haut produit généralement un son plus doux, tandis qu'un archet vers le bas est plus fort et plus affirmé.	An up-bow usually generates a softer sound, while a down-bow is stronger and more assertive.
N'hésitez pas à inscrire vos propres marques au crayon, mais n'oubliez pas que les marques d'archet imprimées le sont pour un motif d'ordre musical, et qu'il faut donc en général les respecter.	Feel free to pencil in your own marks, but remember the printed bowing marks are there for a musical reason, so they should usually be respected.
Ainsi, le crayon était un bon ami pour beaucoup de gens lorsqu’il est sorti.	Thus, the pencil was a good friend to many people when it came out.
Malheureusement, l'apparition de nouveaux modes de rédaction a relégué le stylo à un statut plus confidentiel et à des utilisations plus rares.	Sadly, as newer methods of writing have emerged, the pencil has been relegated to lesser status and uses.
Les gens écrivent maintenant des messages sur des écrans d'ordinateur, sans jamais avoir à s'approcher d'un taille-crayon.	People now write messages on computer screens, never having to come close to a sharpener.
On ne peut que se demander ce que le clavier deviendra quand la prochaine nouveauté arrivera.	One can only wonder what the keyboard will become when something newer comes along.
La bombe à fission fonctionne selon le principe suivant : elle transforme l'énergie en assemblant un noyau d'une myriade de protons et neutrons.	The fission bomb works on the principle that it takes energy to put together a nucleus with many protons and neutrons.
Un peu comme si on faisait gravir une colline à une charrette lourde. En divisant le noyau à nouveau, puis en libérant un peu de cette énergie.	Sort of like rolling a heavy cart up a hill. Splitting the nucleus up again then releases some of that energy.
Certains atomes ont un noyau instable, de sorte qu'ils ont tendance à se briser avec peu ou pas de pression.	Some atoms have unstable nuclei which means that they tend to break apart with little or no nudging.
