Avec la chaleur de la journée, les voyageurs peuvent apercevoir des mirages qui donnent l'illusion de l'eau (ou d'autres choses).	In the heat of the day, travelers can experience mirages that give the illusion of water (or other things).
Celles-ci peuvent être dangereuses si le voyageur poursuit le mirage, gaspillant ainsi une énergie précieuse et l’eau restante.	These can be dangerous if the traveler pursue the mirage, wasting precious energy and remaining water.
Même le plus chaud des déserts peut devenir extrêmement froid la nuit. L'hypothermie est un risque réel si vous n'avez pas de vêtements chauds.	Even the hottest of deserts can become extremely cold at night. Hypothermia is a real risk without warm clothing.
C'est surtout en été qu'il vous faudra faire attention aux moustiques si vous comptez faire de la randonnée en forêt tropicale.	In summer, especially, you'll need to watch out for mosquitoes if you decide to hike through the rainforest.
Même si vous conduisez dans la forêt tropicale, quelques secondes avec les portes ouvertes pendant que vous montez dans le véhicule suffisent pour que les moustiques montent dans le véhicule avec vous.	Even if you're driving through the subtropical rainforest, a few seconds with the doors open while you get inside the vehicle is enough time for mosquitoes to get in the vehicle with you.
La grippe aviaire, ou de manière plus formelle l'influenza aviaire, peut infecter à la fois les oiseaux et les mammifères.	Bird flu, or more formally avian influenza, can infect both birds and mammals.
Moins d'un millier de cas ont été rapportés chez les humains, mais certains ont été mortels.	Fewer than a thousand cases have ever been reported in humans, but some of them have been fatal.
La plupart impliquaient des personnes qui travaillent avec des volailles, mais il existe également un certain risque pour les observateurs d'oiseaux.	Most have involved people who work with poultry, but there is also some risk to birdwatchers.
Les fjords et les vallées escarpées qui cèdent soudainement la place à un haut plateau plus ou moins régulier sont typiques de la Norvège.	Typical for Norway are steep fjords and valleys that suddenly give way to a high, more or less even plateau.
Ces plateaux sont souvent appelés « vidde », pour désigner un vaste espace sans arbre, une étendue sans limites.	These plateaus are often referred to as "vidde" meaning a wide, open treeless space, a boundless expanse.
Dans le Rogaland et à Adger, ils sont souvent qualifiés de « hei », ce qui signifie landes déboisées souvent couvertes de bruyère.	In Rogaland and Agder they are usually called "hei" meaning a treeless moorland often covered in heather.
Les glaciers ne sont pas stables, mais se détachent de la montagne. Cela provoque des fissures, des crevasses, qui peuvent être obscurcies par des ponts de neige.	The glaciers are not stable, but flow down the mountain. This will cause cracks, crevasses, which may be obscured by snow bridges.
Les murs et les toits des grottes de glace peuvent s’effondrer et les fissures se refermer.	The walls and roofs of ice caves can collapse and cracks can get closed.
Au bord des glaciers, d'immenses blocs se détachent, tombent, et peut-être rebondissent ou roulent en s'éloignant du bord.	At the edge of glaciers huge blocks break loose, fall down and perhaps jump or roll farther from the edge.
La saison touristique des stations de montagne culmine généralement pendant l'été indien.	The tourist season for the hill stations generally peaks during the Indian summer.
Cependant, leur beauté et leur charme évoluent en hiver, avec de nombreuses stations de montagne pourvues de bonnes quantités de neige et proposant des activités telles que le ski et le snowboard.	However, they have a different kind of beauty and charm during winter, with many hill stations receiving healthy amounts of snow and offering activities such as skiing and snowboarding.
Les observatoires prémodernes sont généralement obsolètes aujourd’hui, et restent en place comme musées ou sites d’éducation.	Pre-modern observatories are usually obsolete today, and remain as museums, or sites of education.
Comme la pollution lumineuse à leur époque n'était pas aussi préoccupant qu'aujourd'hui, ils sont généralement situés dans des villes ou sur des campus, plus faciles d'accès que ceux construits à l'époque moderne.	As light pollution in their heyday was not the kind of problem it is today, they are usually located in cities or at campuses, easier to reach than those built in modern times.
La plupart des télescopes de recherche modernes sont d'énormes infrastructures placées dans des régions éloignées où les conditions atmosphériques sont favorables.	Most modern research telescopes are enormous facilities in remote areas with favorable atmospheric conditions.
La contemplation des fleurs de cerisier, connue sous le nom de hanami, fait partie de la culture japonaise depuis le VIIIe siècle.	Cherry blossom viewing, known as hanami, has been a part of Japanese culture since the 8th century.
Le concept est venu de Chine où les fleurs de prunier étaient la fleur de prédilection.	The concept came from China where plum blossoms were the flower of choice.
Au Japon, les premières fêtes des cerisiers en fleurs ont été organisées par l’empereur uniquement pour lui-même et les autres membres de l’aristocratie proche autour de la Cour impériale.	In Japan, the first cherry blossom parties were hosted by the emperor only for himself and other members of the aristocracy around the Imperial Court.
Les plantes revêtent leur plus belle apparence lorsqu'elles se trouvent dans un environnement naturel, alors résistez à la tentation d'en retirer ne serait-ce qu'« une seule ».	Plants look their best when in a natural environment, so resist the temptation to remove even "just one" specimen.
Si vous visitez un jardin strictement aménagé, le prélèvement de « spécimens » va également vous faire expulser sans discussion.	If visiting a formally arranged garden, collecting "specimens" is also going to get you ejected, without discussion.
Singapour est généralement considéré comme un endroit extrêmement sûr, où il est très aisé de se déplacer, et où vous pourrez acheter presque tout ce dont vous avez besoin une fois arrivé sur place.	Singapore is generally an extremely safe place to be and very easy to navigate, and you can buy almost anything after arriving.
Mais, situé dans les « tropiques élevées » à seulement quelques degrés au nord de l'équateur, il faudra vous adapter à la chaleur (toujours) et à un fort rayonnement du soleil (quand le ciel est dégagé, ce qui est plus rare).	But being placed in the "high tropics" just a few degrees north of equator you will need to deal with both heat (always) and strong sun (when the sky is clear, more rarely).
Il y a aussi quelques bus qui se rendent au nord à Hébron, le lieu de sépulture traditionnel des patriarches bibliques, Abraham, Isaac, Jacob et leurs épouses.	There are also a few buses going north to Hebron, the traditional burial place of the Biblical patriarchs Abraham, Isaac, Jacob, and their wives.
Vérifiez que le bus que vous envisagez de prendre se rend à Hébron et pas seulement à la colonie juive voisine de Kyriat Arba.	Check that the bus you are thinking of taking goes into Hebron and not just to the nearby Jewish settlement of Kiryat Arba.
Les voies navigables intérieures peuvent être un excellent thème pour des vacances.	Inland waterways can be a good theme to base a holiday around.
Par exemple, visiter des châteaux dans la vallée de la Loire, la vallée du Rhin ou faire une croisière vers des sites intéressants sur le Danube ou faire du bateau le long du canal Erie.	For example visiting castles in the Loire Valley, the Rhine valley or taking a cruise to interesting cites on the Danube or boating along the Erie Canal.
Elles définissent également les itinéraires pour les sentiers de randonnée et les pistes cyclables populaires.	They also define routes for popular hiking and cycling trails.
Tous les animaux qui sont arrivés sur ces îles l'ont fait à l'origine par les eaux, à la nage ou à bord d'objets flottants, ou par les airs.	All animals that originally arrived in the islands came here either by swimming, flying or floating.
En raison de la grande distance qui les sépare du continent, les mammifères n’ont pas pu aller au bout du voyage, faisant de la tortue géante le principal animal de pâturage des Galapagos.	Due to the long distance from the continent mammals were unable to make the journey making the giant tortoise the primary grazing animal in the Galapagos.
Depuis l’arrivée de l’homme aux Galapagos, de nombreux mammifères ont été introduits, notamment des chèvres, des chevaux, des vaches, des rats, des chats et des chiens.	Since the arrival of man to the Galapagos, many mammals have been introduced including goats, horses, cows, rats, cats and dogs.
Si vous visitez les régions arctiques ou antarctiques en hiver, vous pourrez découvrir la nuit polaire, durant laquelle le soleil ne se lève pas au-dessus de l'horizon.	If you visit the Arctic or Antarctic areas in the winter you will experience the polar night, which means that the sun doesn't rise above the horizon.
C'est une bonne occasion d'admirer les aurores boréales, car le ciel sera sombre pratiquement toute la journée.	This offers a good opportunity to see the Aurora borealis, as the sky will be dark more or less around the clock.
Comme les régions sont peu peuplées, et que la pollution lumineuse n'est donc souvent pas un problème, vous pourrez également profiter des étoiles.	As the areas are sparsely populated, and light pollution therefore often not a problem, you will also be able to enjoy the stars.
