La manifestation a commencé vers 11 h heure locale (UTC+1) sur Whitehall, en face de l'entrée gardée par la police de Downing Street, la résidence officielle du Premier ministre.	The protest started around 11:00 local time (UTC+1) on Whitehall opposite the police-guarded entrance to Downing Street, the Prime Minister's official residence.
À Whitehall, peu après 11 h 00, des manifestants ont bloqué la circulation des véhicules en direction du nord.	Just after 11:00, protesters blocked traffic on the northbound carriage in Whitehall.
À 11 h 20, la police a demandé aux manifestants de retourner sur le trottoir, déclarant qu’ils devaient trouver un équilibre entre le droit de manifester et l’augmentation de la circulation.	At 11:20, the police asked the protesters to move back on to the pavement, stating that they needed to balance the right to protest with the traffic building up.
A 11 h 29, la manifestation s'est déplacée vers Whitehall, devant Trafalgar Square, le long du Strand, en passant par Aldwych et en remontant Kingsway vers Holborn, où le Parti Conservateur tenait son Forum de printemps à l'hôtel Grand Connaught Rooms.	Around 11:29, the protest moved up Whitehall, past Trafalgar Square, along the Strand, passing by Aldwych and up Kingsway towards Holborn where the Conservative Party were holding their Spring Forum in the Grand Connaught Rooms hotel.
Né à Hong Kong, Ma a étudié à l'université de New York et à la faculté de droit de Harvard et a déjà été titulaire d'une « carte verte », la carte de résident permanent des États-Unis.	Born in Hong Kong, Ma studied at New York University and Harvard Law School and once held an American permanent resident "green card".
Hsieh a laissé entendre pendant les élections que Ma pourrait fuir le pays à l'occasion d'une crise.	Hsieh implied during the election that Ma might flee the country during a time of crisis.
Hsieh a également affirmé que le très photogénique Ma offrait plus de style que de véritables idées.	Hsieh also argued that the photogenic Ma was more style than substance.
Peter Costello, ministre des Finances australien et probable successeur du Premier ministre John Howard à la tête du parti libéral, s'est déclaré favorable à l'idée d'une industrie nucléaire australienne.	Peter Costello, Australian treasurer and the man most likely to succeed Prime Minister John Howard as Liberal party leader has thrown his support behind a nuclear power industry in Australia.
M. Costello a déclaré qu'alors que la production d’énergie nucléaire devient économiquement viable, l'Australie a tout intérêt à poursuivre son utilisation.	Mr Costello said that when nuclear power generation becomes economically viable, Australia should pursue its use.
"""Si cela devient un marché rentable, nous nous devons d'y être présent. Il n'y a en principe aucune opposition à l’énergie nucléaire"" a déclaré M. Costello."	"If it becomes commercial, we should have it. That is, there's no in-principle objection to nuclear energy" Mr Costello said.
Roberts a refusé catégoriquement de clarifier à quel moment il croyait que la vie commence après conception, une question importante dans le cadre du débat éthique sur l'avortement, en répondant qu'il serait contraire à la déontologie de s'exprimer sur des détails précis qui pourraient faire partie de cas juridiques probables.	Roberts flatly refused to say about when he believes life begins, an important question when considering the ethics of abortion, saying that it would be unethical to comment on the specifics of likely cases.
Il a toutefois réitéré sa précédente déclaration selon laquelle Roe v. Wade était le « droit établi du pays », soulignant l’importance de la cohérence des décisions de la Cour suprême.	He did, however, reiterate his earlier statement that Roe v. Wade was the "settled law of the land", emphasizing the importance of consistent Supreme Court rulings.
Il a également confirmé sa conviction personnelle au droit implicite à la vie privée, dont dépend la décision de Roe.	He also confirmed that he believed in the implied right to privacy which the Roe decision depended upon.
Lodin a également déclaré que les responsables ont décidé d'annuler le second tour afin d'épargner aux Afghans les dépenses et les risques de sécurité d'une autre élection.	Lodin also said officials decided to cancel the runoff in order to save Afghans the expense and security risk of another election.
Les diplomates ont déclaré qu'ils avaient trouvé suffisamment d'ambiguïté dans la constitution afghane pour déterminer que le second scrutin était inutile.	Diplomats said that they had found enough ambiguity in the Afghan constitution to determine the runoff as unnecessary.
Cela contredit les rapports précédents, selon lesquels l'annulation du ruissellement aurait été contraire à la constitution.	This contradicts earlier reports, which said that cancelling the runoff would have been against the constitution.
Ces commentaires, en direct à la télévision, étaient la première fois que des sources iraniennes de haut niveau ont admis que les sanctions avaient un effet quelconque.	The comments, live on television, were the first time that senior Iranian sources have admitted that the sanctions are having any effect.
Elles comprennent des restrictions financières et une interdiction par l'Union européenne sur l'exportation de pétrole brut, de laquelle l'économie iranienne reçoit 80 % de ses revenus étrangers.	They include financial restrictions and a ban by the European Union on the export of crude oil, from which the Iranian economy receives 80% of its foreign income.
Dans son dernier rapport mensuel, l'OPEP a déclaré que les exportations de brut étaient tombées à leur niveau le plus bas depuis deux décennies, soit 2,8 millions de barils par jour.	In its most recent monthly report, OPEC said exports of crude had fallen to their lowest level for two decades at 2.8 million barrels per day.
Le chef suprême du pays, l’ayatollah Ali Khamenei, a décrit la dépendance au pétrole comme un « piège » datant d’avant la révolution islamique iranienne de 1979, et dont le pays devrait se libérer.	The country's supreme leader, Ayatollah Ali Khamenei, has described the dependency on oil as "a trap" dating from before Iran's Islamic revolution in 1979 and from which the country should free itself.
L'ACMA a également conclu que, même si la vidéo était diffusée en continu sur Internet, Big Brother n'avait pas enfreint la législation sur la censure du contenu en ligne, car le contenu multimédia n'avait pas été stocké sur le site de Big Brother.	The ACMA also found that despite the video being streamed on the Internet, Big Brother had not breached online content censorship laws as the media had not been stored on Big Brother's website.
La loi sur les services de radiodiffusion prévoit la réglementation du contenu Internet, mais pour être considéré comme un contenu Internet, il doit physiquement résider sur un serveur.	The Broadcasting Services Act provides for the regulation of Internet content, however to be considered Internet content, it must physically reside on a server.
"L'ambassade des États-Unis à Nairobi au Kenya, a lancé une mise en garde, contre des ""extrémistes en provenance de Somalie"" qui projetteraient des attentats- suicides à la bombe sur les sols kényan et éthiopien."	The United States embassy located in Nairobi, Kenya has issued a warning that "extremists from Somalia" are planning to launch suicide bomb attacks in Kenya and Ethiopia.
Les États-Unis disent avoir appris d’une source anonyme que des kamikazes seraient utilisés pour faire exploser des « sites importants » en Éthiopie et au Kenya.	The U.S. says it has received information from an undisclosed source that specifically mentions the use of suicide bombers to will blow up "prominent landmarks" in Ethiopia and Kenya.
L'annonce d'aujourd'hui prolonge également l'engagement pris par le gouvernement en mars de cette année de financer des voitures supplémentaires.	Today's announcement also extended the government's commitment made in March of this year to fund extra carriages.
Avec 300 de plus on atteint un total de 1 300 wagons à acquérir pour soulager la congestion des transports.	An additional 300 brings the total to 1,300 carriages to be acquired to relieve overcrowding.
Accompagné de ces autorités, il a assuré aux citoyens du Texas que des mesures étaient prises pour protéger la sécurité du public.	Accompanied by those officials, he assured Texas citizens that steps were being taken to protect the public's safety.
Perry a spécifiquement déclaré : « Il y a peu d'endroits dans le monde qui soient mieux équipés pour relever le défi qui est posé dans ce cas ».	Perry specifically said, "There are few places in the world better equipped to meet the challenge that is posed in this case."
Le gouverneur a également déclaré : « Aujourd'hui, nous avons appris que certains enfants d'âge scolaire ont été identifiés comme ayant eu des contacts avec le patient. »	The governor also stated, "Today, we learned that some school aged children have been identified as having had contact with the patient."
"Il continua en disant, ""Il s'agit là d'une affaire sérieuse. Soyez certains que notre système fonctionne aussi bien qu'il le devrait."""	He went on to say, "This case is serious. Rest assured that our system is working as well as it should."
Depuis l'indépendance du Pakistan, qui s'est affranchi de la domination britannique en 1947, le président pakistanais a nommé des « agents politiques » pour gouverner les zones tribales, ceux-ci exerçant un contrôle indépendant quasi complet sur ces régions.	Since Pakistani independence from British rule in 1947, the Pakistani President has appointed "Political Agents" to govern FATA, who exercise near-complete autonomous control over the areas.
Ces agents ont la responsabilité de prévoir les services gouvernementaux et judiciaires prévus sous l'Article 247 de la Constitution pakistanaise.	These agents are responsible for providing government and judicial services under Article 247 of the Pakistani Constitution.
Le Nigeria avait précédemment annoncé qu'il avait l'intention de rejoindre l'AfCFTA dans la semaine précédant le sommet.	Nigeria previously announced it planned to join the AfCFTA in the week leading up to the summit.
Le commissaire au commerce et à l'industrie de l'Union africaine, Albert Muchanga, a annoncé l'adhésion du Bénin.	AU trade and industry commissioner Albert Muchanga announced Benin was to join.
Le commissaire a dit : « nous ne nous sommes pas encore accordés sur les règles de base, ni sur les concessions tarifaires, mais la perspective envisagée est suffisante pour débuter le commerce d'ici le 1er juillet 2020 ».	The commissioner said, "We haven't yet agreed on rules of origin and tariff con[c]essions, but the framework we have is enough to start trading on July 1, 2020".
L'ancien gouverneur du Massachusetts, Mitt Romney, a remporté les élections primaires présidentielles du Parti républicain de Floride mardi avec plus de 46 % des voix.	Former Massachusetts governor Mitt Romney won the Florida Republican Party presidential primary election on Tuesday with over 46 percent of the vote.
L'ancien président de la Chambre des représentants des États-Unis, Newt Gingrich, est arrivé en deuxième position avec 32 %.	Former U.S. Speaker of the House Newt Gingrich came in second with 32 percent.
En tant qu'état où le vainqueur remporte tout, la Floride a décerné à Romney ses cinquante délégués, le poussant ainsi en tête de liste pour la nomination du parti républicain.	As a winner-takes-all state, Florida awarded all fifty of its delegates to Romney, pushing him ahead as the front-runner for the Republican Party nomination.
Les organisateurs de la manifestation ont affirmé qu'environ 100 000 personnes se sont présentées dans plusieurs villes allemandes telles que Berlin, Cologne, Hambourg et Hanovre.	Organisers of the protest said about 100,000 people turned up in German cities such as Berlin, Cologne, Hamburg, and Hanover.
À Berlin, la police estime qu'il y avait environ 6 500 manifestants.	In Berlin, police estimated 6,500 protestors.
Des manifestations ont également eu lieu à Paris, Sofia en Bulgarie, Vilnius en Lituanie, La Valette à Malte, Tallinn en Estonie, et Édimbourg et Glasgow en Écosse.	Protests also took place in Paris, Sofia in Bulgaria, Vilnius in Lithuania, Valetta in Malta, Tallinn in Estonia, and Edinburgh and Glasgow in Scotland.
À Londres, environ 200 personnes ont manifesté devant les bureaux de certains grands détenteurs de droits d’auteur.	In London, about 200 people protested outside some major copyright holders' offices.
Le mois dernier, il y a eu de grandes manifestations en Pologne lorsque le pays a signé l'ACTA, ce qui a décidé le gouvernement polonais à ne pas ratifier l'accord pour l'instant.	Last month, there were major protests in Poland when that country signed ACTA, which has led to the Polish government deciding not to ratify the agreement, for now.
La Lettonie et la Slovaquie ont toutes deux retardé le processus d'adhésion à l'ACTA.	Latvia and Slovakia have both delayed the process of joining ACTA.
"En ce qui concerne la situation financière mondiale, Zapatero a poursuivi en disant que ""le système financier fait partie de l’économie, un élément essentiel."	Regarding the global financial situation, Zapatero continued by saying that "the financial system is a part of the economy, a crucial part.
Nous traversons une crise financière d'un an, qui a connu son moment le plus aigu au cours des deux derniers mois, et je pense que maintenant les marchés financiers commencent à se redresser. »	We have a year-long financial crisis, which has had its most acute moment in the past two months, and I think now the financial markets are beginning to recover."
Tout au long des années 1960, Brzezinski a travaillé pour John F. Kennedy en tant que conseiller, puis pour l'administration de Lyndon B. Johnson.	Throughout 1960s, Brzezinski worked for John F. Kennedy as his advisor and then the Lyndon B. Johnson administration.
Lors des sélections de 1976, il a conseillé Carter en matière de politique étrangère, puis a été conseiller à la sécurité nationale (NSA) de 1977 à 1981, succédant à Henry Kissinger.	During the 1976 selections he advised Carter on foreign policy, then served as National Security Advisor (NSA) from 1977 to 1981, succeeding Henry Kissinger.
Pendant son temps au sein de la NSA, il a aidé Carter à résoudre diplomatiquement des questions internationales telles que les accords de Camp David, en 1978, la normalisation des relations entre les États-Unis et la Chine à la fin des années 1970, la révolution iranienne et ses conséquences comme la prise d'otages en Iran, en 1979, et l'invasion des forces soviétiques en Afghanistan, en 1979.	As NSA, he assisted Carter in diplomatically handling world affairs, such as the Camp David Accords, 1978; normalizing US–China relations thought the late 1970s; the Iranian Revolution, which led to the Iran hostage crisis, 1979; and the Soviet invasion in Afghanistan, 1979.
Tard dimanche, le président des États-Unis Donald Trump, dans une déclaration faite par l'intermédiaire du secrétaire de presse, a annoncé que les troupes américaines allaient se retirer de la Syrie.	Late on Sunday, the United States President Donald Trump, in a statement delivered via the press secretary, announced US troops would be leaving Syria.
L’annonce a été faite après que M. Trump ait eu une conversation téléphonique avec le président turc Recep Tayyip Erdoğan.	The announcement was made after Trump had a phone conversation with Turkish President Recep Tayyip Erdoğan.
La Turquie prendrait également en charge la garde des combattants d'ISIS capturés que, selon la déclaration, les nations européennes ont refusé de rapatrier.	Turkey would also take over guarding captured ISIS fighters which, the statement said, European nations have refused to repatriate.
Une voiture piégée a explosé au siège de la police à Gaziantep, en Turquie, hier matin, tuant deux officiers de police et blessant plus de vingt autres personnes.	A car bomb detonated at police headquarters in Gaziantep, Turkey yesterday morning killed two police officers and injured more than twenty other people.
Le bureau du gouverneur a déclaré que dix-neuf des blessés étaient des officiers de police.	The governor's office said nineteen of the injured were police officers.
La police a déclaré soupçonner un militant présumé de Daesh (ÉI) comme le suspect à l'origine de cette attaque.	Police said they suspect an alleged Daesh (ISIL) militant of responsibility for the attack.
Duvall, qui est marié et a deux enfants adultes, n’a pas fait bonne impression à Miller, à qui l’histoire a été relatée.	Duvall, who is married with two adult children, did not leave a big impression on Miller, to whom the story was related.
Lorsqu'on lui a demandé de commenter, Miller a déclaré : « Mike parle beaucoup pendant l'audience… Je me préparais, donc je n'ai pas vraiment entendu ce qu'il disait ».	When asked for comment, Miller said, "Mike talks a lot during the hearing...I was getting ready so I wasn't really hearing what he was saying."
Le groupe d’étude sur l’Irak a présenté son rapport aujourd’hui à 12 h GMT.	The Iraq Study Group presented its report at 12.00 GMT today.
Il avertit que personne ne peut garantir que toute action en Irak à ce stade mettra fin à la guerre sectaire, à la violence croissante ou au glissement vers le chaos.	It warns No one can guarantee that any course of action in Iraq at this point will stop sectarian warfare, growing violence, or a slide toward chaos.
Le rapport s'ouvre par un appel à un débat ouvert et à la formation d'un consensus aux États-Unis sur la politique à l'égard du Moyen-Orient.	The Report opens with plea for open debate and the formation of a consensus in the United States about the policy towards the Middle East.
Le rapport est très critique envers presque tous les aspects de la politique actuelle du gouvernement à l'égard de l'Irak et plaide vivement pour un changement de direction immédiat.	The Report is highly critical of almost every aspect of the present policy of the Executive towards Iraq and it urges an immediate change of direction.
La première de ses 78 recommandations est qu'une nouvelle initiative diplomatique devrait être prise avant la fin de l'année pour sécuriser les frontières de l'Irak contre les interventions hostiles et afin de rétablir les relations diplomatiques avec ses voisins.	First among its 78 recommendations is that a new diplomatic initiative should be taken before the end of this year to secure Iraq’s borders against hostile interventions and to re-establish diplomatic relations with its neighbors.
L'actuelle sénatrice et Première Dame d'Argentine Cristina Fernandez de Kirchner a annoncé sa candidature présidentielle, hier soir, à La Plata, une ville située à 50 kilomètres (31 miles) de Buenos Aires.	Current senator and Argentine First Lady Cristina Fernandez de Kirchner announced her presidential candidacy yesterday evening in La Plata, a city 50 kilometers (31 miles) away from Buenos Aires.
Mme Kirchner a annoncé son intention de se présenter à la présidence au Théâtre argentin, le même endroit où elle a commencé sa campagne 2005 pour le Sénat en tant que membre de la délégation de la province de Buenos Aires.	Mrs. Kirchner announced her intention to run for president at the Argentine Theatre, the same location she used to start her 2005 campaign for the Senate as member of the Buenos Aires province delegation.
Le débat a été déclenché par la controverse sur les dépenses liées aux secours et à la reconstruction à la suite de l'ouragan Katrina ; ce que certains conservateurs en matière budgétaire ont appelé avec humour « l'accord Bush pour la Nouvelle-Orléans ».	The debate was sparked by controversy over spending on relief and reconstruction in the wake Hurricane Katrina; which some fiscal conservatives have humorously labeled "Bush's New Orleans Deal."
Les critiques des libéraux sur l'effort de reconstruction se sont concentrées sur l'attribution de contrats de reconstruction à des personnes perçues comme des initiés de Washington.	Liberal criticism of the reconstruction effort has focused on the awarding of reconstruction contracts to perceived Washington insiders.
Le président américain George W. Bush est arrivé à Singapour le matin du 16 novembre, débutant une tournée d’une semaine en Asie.	U.S. President George W. Bush arrived in Singapore the morning of November 16, beginning a week-long tour of Asia.
Il a été accueilli par Wong Kan Seng, le vice-premier ministre de Singapour, et a discuté de commerce et de terrorisme avec Lee Hsien Loong, le Premier ministre de Singapour.	He was greeted by Singapore's Deputy Prime Minister Wong Kan Seng and discussed trade and terrorism issues with the Singapore Prime Minister Lee Hsien Loong.
Après sept jours de défaites électorales aux élections de mi-mandat, Bush a fait part de son projet d'élargir le commerce en Asie.	After a week of losses in the midterm election, Bush told an audience about the expansion of trade in Asia.
Le Premier ministre Stephen Harper a accepté d'envoyer la « loi sur la qualité de l'air » du gouvernement à un comité multipartite pour examen, avant sa deuxième lecture, après la réunion de 25 minutes de mardi avec le chef du NPD, Jack Layton, au CPM.	Prime Minister Stephen Harper has agreed to send the government's 'Clean Air Act' to an all-party committee for review, before its second reading, after Tuesday's 25 minute meeting with NDP leader Jack Layton at the PMO.
Layton avait demandé des changements au sujet du projet de loi environnemental des conservateurs lors de la réunion avec le premier ministre, demandant une « reformulation complète et approfondie » du projet de loi environnemental du parti conservateur.	Layton had asked for changes to the conservatives' environmental bill during the meeting with the PM, asking for a "thorough and complete rewriting" of the Conservative party's environmental bill.
Et depuis, le gouvernement fédéral a pris les devants en se chargeant du financement du Mersey Hospital à Devonport, en Tasmanie. Le gouvernement d'état et certains parlementaires ont qualifié cet acte de farce à l'approche des élections de novembre.	Ever since the Federal Government stepped in to take over funding of the Mersey hospital in Devonport, Tasmania, the state government and some federal MPs have criticised this act as a stunt in the prelude to the federal election to be called by November.
Mais le Premier ministre John Howard a déclaré que cette loi visait uniquement à éviter que les installations de l'hôpital ne soient déclassées par le gouvernement de Tasmanie, en donnant 45 millions de dollars australiens supplémentaires.	But Prime Minister John Howard has said the act was only to safeguard the facilities of the hospital from being downgraded by the Tasmanian government, in giving an extra AUD$45 million.
Le président américain George W. Bush a accueilli cette annonce avec satisfaction.	U.S. President George W. Bush welcomed the announcement.
Le porte-parole de Bush, Gordon Johndroe, a qualifié la promesse de la Corée du Nord « d'étape majeure vers l'objectif de la dénucléarisation vérifiable de la péninsule coréenne ».	Bush spokesman Gordon Johndroe called North Korea's pledge "a major step towards the goal of achieving the verifiable denuclearization of the Korean peninsula."
Les résultats définitifs des élections présidentielles et parlementaires namibiennes indiquent que le président sortant, Hifikepunye Pohamba, a été réélu par une large majorité.	Final results from Namibian presidential and parliamentary elections have indicated that the incumbent president, Hifikepunye Pohamba, has been reelected by a large margin.
Le parti au pouvoir, l'Organisation du peuple du Sud-Ouest africain (SWAPO), a lui aussi réussi à conserver la majorité aux élections législatives.	The ruling party, South West Africa People's Organisation (SWAPO), also retained a majority in the parliamentary elections.
Les troupes de coalition et Afghanes se sont déplacées dans la zone pour sécuriser le site et un avion d’une autre coalition a été envoyé pour seconder.	Coalition and Afghan troops moved into the area to secure the site and other coalition aircraft have been sent to assist.
L’accident a eu lieu en terrain montagneux, et il semblerait que cela ait été causé par un incendie malveillant.	The crash occurred high up in mountainous terrain, and is believed to have been the result of hostile fire.
Les efforts visant à trouver le lieu de l’accident sont restreints par des intempéries et le terrain accidenté.	Efforts to search for the crash site are being met by bad weather and harsh terrain.
En France, le vote est traditionnellement une expérience de faible technicité : les électeurs s’isolent dans une cabine, mettent dans une enveloppe une feuille de papier pré-imprimée indiquant le candidat de leur choix.	In France, voting has traditionally been a low-tech experience: voters isolate themselves in a booth, put a pre-printed sheet of paper indicating their candidate of choice into an envelope.
Après que les agents ont vérifié son identité, l’électeur jette l’enveloppe dans l’urne et signe sa carte d’électeur.	After officials verify the voter's identity, the voter drops the envelope into the ballot box and signs the voting roll.
Le Code électoral français réglemente les opérations de façon assez stricte.	French electoral law rather strictly codifies the proceedings.
Depuis 1988, les urnes doivent être transparentes afin que les électeurs et les observateurs puissent constater qu'aucune enveloppe n'est présente au début du vote et qu'aucune enveloppe n'est ajoutée, sauf celles des électeurs dûment comptés et autorisés.	Since 1988, ballot boxes must be transparent so that voters and observers can witness that no envelopes are present at the start of the vote and that no envelopes are added except those of the duly counted and authorized voters.
Les candidats peuvent envoyer des représentants pour assister à chaque étape du processus. Le soir, les votes sont comptés par des bénévoles sous haute surveillance, selon des procédures spécifiques.	Candidates can send representatives to witness every part of the process. In the evening, votes are counted by volunteers under heavy supervision, following specific procedures.
Newt Gingrich, l’ancien président de la Chambre des représentants, Rick Perry, le gouverneur du Texas, et la sénatrice Michele Bachmann ont terminé respectivement à la quatrième, cinquième et sixième place.	Former House Speaker Newt Gingrich, Texas governor Rick Perry, and Congresswoman Michele Bachmann finished in fourth, fifth, and sixth place, respectively.
Après publication des résultats, Newt Gingrich a félicité Rick Santorum, mais a eu des mots durs à l'encontre de Mitt Romney, au nom de qui des campagnes publicitaires négatives avaient été diffusées en Iowa contre Newt Gingrich.	After the results came in, Gingrich lauded Santorum, but had tough words for Romney, on whose behalf negative campaign advertisements were aired in Iowa against Gingrich.
Perry a déclaré qu'il « retournerait au Texas pour évaluer les résultats du caucus de ce soir, et déterminer s'il y a une voie à suivre pour moi dans cette course », mais il a affirmé plus tard qu'il resterait dans la course et participerait aux primaires du 21 janvier en Caroline du Sud.	Perry stated that he would "return to Texas to assess the results of tonight's caucus, determine whether there is a path forward for myself in this race", but later said that he would remain in the race and compete in the January 21 South Carolina primary.
Bachmann, qui avait gagné le « vote de paille » d’Âmes en août, décida de mettre un terme à sa campagne.	Bachmann, who won the Ames Straw Poll in August, decided to end her campaign.
Je ne sais pas si vous vous en rendez compte, mais la plupart des marchandises en provenance d'Amérique centrale sont entrées dans notre pays exonérées de taxes.	I don't know if you realize it or not, but most of the goods from Central America came into this country duty-free.
Pourtant, 80 % de nos marchandises étaient taxées par des droits de douane dans les pays d’Amérique centrale. Nous vous soignons.	Yet eighty percent of our goods were taxed through tariffs in Central American countries. we treat you.
Cela ne me semblait pas logique ; ce n'était certainement pas juste.	That didn't seem to make sense to me; it certainly wasn't fair.
Tout ce que je dis aux gens, c’est que vous nous traitez comme nous vous traitons.	All I say to people is you treat us the way we treat you.
Le gouverneur de Californie, Arnold Schwarzenegger, a promulgué une loi qui interdit la vente ou la location de jeux vidéo violents aux mineurs.	California Governor Arnold Schwarzenegger signed into law a bill that bans the sale or rental of violent video games to minors.
Le projet de loi exige que les jeux vidéo violents vendus dans l'État de Californie soient étiquetés avec un autocollant portant la mention « 18 » et rend leur vente à un mineur passible d'une amende de 1000 dollars par infraction.	The bill requires violent video games sold in the state of California to be labeled with a decal reading "18" and makes their sale to a minor punishable by a fine of $1000 per offense.
Le directeur des poursuites publiques, Kier Starmer QC, a fait une déclaration ce matin annonçant la poursuite de Huhne et Pryce.	The Director of Public Prosecutions, Kier Starmer QC, gave a statement this morning announcing the prosecution of both Huhne and Pryce.
Huhne a démissionné et il sera remplacé au sein du cabinet par le député Ed Davey. Le député Norman Lamb devrait prendre le poste de ministre des Affaires auquel Davey se désiste.	Huhne has resigned and he will be replaced in the Cabinet by Ed Davey MP. Norman Lamb MP is expected to take the Business Minister job Davey is vacating.
Huhne et Pryce doivent comparaître devant la Magistrates Court de Westminster le 16 février.	Huhne and Pryce are scheduled to appear at the Westminster Magistrates Court on February 16.
D'après la fuite, le document portera sur le différend à la frontière que la Palestine revendique sur la base des frontières existantes avant la guerre du Moyen-Orient de 1967.	The document, according to the leak, will refer to the borders dispute, which Palestine wants based on the borders before the 1967 Mideast War.
Parmi les autres sujets abordés figurent le futur État de Jérusalem, qui est sacré pour les deux nations, et la question de la vallée du Jourdain.	Other topics covered reportedly include the future state of Jerusalem which is sacred to both nations and the Jordan Valley issue.
Israël exige une présence militaire permanente dans la vallée pour une durée de dix années à compter de la signature d'un accord, tandis que l'Autorité palestinienne ne consent qu'à une durée de cinq ans.	Israel demands an ongoing military presence in the valley for ten years once an agreement is signed while the PA agrees to leave such presence only for five years.
Un sondage effectué auprès de 1 400 personnes avant les élections fédérales de 2010 a révélé que le nombre d'opposants à la transformation de l'Australie en république avait augmenté de 8 % depuis 2008.	Out of 1,400 people polled prior to the 2010 federal election, those who oppose Australia becoming a republic grew by 8 per cent since 2008.
La première ministre intérimaire Julia Gillard a déclaré pendant la campagne des élections fédérales de 2010 qu'elle pensait que l'Australie devrait devenir une république à la fin du règne de la reine Elizabeth II.	Caretaker Prime Minister Julia Gillard claimed during the campaign of the 2010 federal election that she believed Australia should become a republic at the end of Queen Elizabeth II's reign.
34 % des personnes interrogées partagent ce point de vue, et souhaitent que la reine Elizabeth II soit la dernière monarque à régner sur l'Australie.	34 per cent of those in the poll share this view, wanting Queen Elizabeth II to be Australia's last monarch.
Aux extrêmes du sondage, 29 % des personnes interrogées pensent que l'Australie devrait devenir une république le plus rapidement possible, tandis que 31 % pensent que l'Australie ne devrait jamais devenir une république.	At the extremes of the poll, 29 per cent of those surveyed believe Australia should become a republic as soon as possible, while 31 per cent believe Australia should never become a republic.
Cuomo, 53 ans, a commencé son mandat de gouverneur au début de cette année et a signé le mois dernier un projet de loi légalisant le mariage entre personnes du même sexe.	Cuomo, 53, began his governorship earlier this year and signed a bill last month legalizing same-sex marriage.
Il a qualifié les rumeurs de « bavardages et de bêtises politiques ».	He referred to the rumors as "political chatter and silliness".
On pense qu'il se présentera à la présidence en 2016.	He is speculated to make a run for president in 2016.
