L’Hesperonychus elizabethae est une espèce de la famille des Dromaeosauridae et un cousin du Velociraptor.	Hesperonychus elizabethae is a species of the family Dromaeosauridae and is a cousin of Velociraptor .
On estime que ce rapace au plumage fourni et au sang chaud se tenait autrefois debout sur deux pattes munies de griffes, à l'instar du vélociraptor.	This fully feathered, warm blooded bird of prey was believed to have walked upright on two legs with claws like the Velociraptor.
Sa deuxième griffe était plus grande, ce qui a engendré le nom Hesperonychus, qui signifie « griffe occidentale ».	Its second claw was larger, giving rise to the name Hesperonychus which means "western claw."
Quand la capsule rentrera dans l’atmosphère terrestre, vers 5 heures du matin (heure de l’Est), elle offrira un spectacle lumineux spectaculaire aux habitants du nord de la Californie, de l’Oregon, du Nevada et de l’Utah.	When the capsule gets to Earth and enters the atmosphere, at about 5am (eastern time), it is expected to put on quite a light show for folks in Northern California, Oregon, Nevada, and Utah.
La capsule ressemblera beaucoup à une étoile filante qui traverse le ciel.	The capsule will look much like a shooting star going across the sky.
La capsule voyagera à environ 8 miles (soit 12,8 km) par seconde, vitesse qui lui permettrait d’aller de San Francisco à Los Angeles en une minute.	The capsule will be traveling at about 12.8 km or 8 miles per second, fast enough to go from San Francisco to Los Angeles in one minute.
Stardust établira un nouveau record historique pour être le vaisseau spatial le plus rapide à revenir sur Terre, battant le précédent record établi en mai 1969 lors du retour du module de commande d'Apollo X.	Stardust will set a new all-time record for being the fastest spacecraft to return to Earth, breaking the previous record set in May of 1969 during the return of the Apollo X command module.
« Elle survolera la côte ouest de la Californie du Nord et illuminera le ciel de l’Oregon, du Nevada, de l’Idaho et de l’Utah », a déclaré le directeur de projet de Stardust, Tom Duxbury.	“It will move over the west coast of northern California and will light the sky from California through central Oregon and on through Nevada and Idaho and into Utah,” Tom Duxbury, Stardust's project manager said.
C’est la plus grande acquisition de l’histoire d’eBay.	It is the biggest acquisition in eBay's history.
L'entreprise espère diversifier ses sources de revenus et gagner en popularité dans les régions où Skype occupe une position de force, comme la Chine, l'Europe de l'Est, et le Brésil.	The company hopes to diversify its profit sources and gain popularity in areas where Skype holds a strong position, such as China, Eastern Europe, and Brazil.
Les scientifiques ont soupçonné Encelade d’être géologiquement actif et d’être une source possible de l’anneau E glacé de Saturne.	Scientists have suspected Enceladus as geologically active and a possible source of Saturn's icy E ring.
Encelade est l'objet le plus réfléchissant du système solaire. Il réfléchit environ 90 % de la lumière du soleil qui le frappe.	Enceladus is the most reflective object in the solar system, reflecting about 90 percent of the sunlight that hits it.
« En se basant sur ce fossile, on en déduit que la séparation s’est faite bien avant que ce à quoi on s’attendait d’après les preuves moléculaires.	"Based on this fossil, that means the split is much earlier than has been anticipated by the molecular evidence.
« Cela veut dire que tout doit être remis en place », a déclaré Berhane Asfaw, chercheur au Rift Valley Research Service en Éthiopie et co-auteur de l'étude.	That means everything has to be put back," said researcher at the Rift Valley Research Service in Ethiopia and a co-author of the study, Berhane Asfaw.
Il s’agirait de la cinquième fois dans l'histoire de l’humanité que l'on aurait observé la chute sur la Terre de matières, dont l'analyse chimique aurait confirmé qu'elles seraient originaires de Mars.	This is believed to be the fifth time in history that people have observed what turned out to be chemically confirmed martian material falling to Earth.
Sur approximativement 24 000 météorites recensées tombées sur Terre, seules 34 environ ont une origine martienne démontrée.	Out of the approximately 24,000 known meteorites to have fallen to Earth, only about 34 have been verified to be martian in origin.
Quinze de ces roches sont attribuées à la pluie de météorites de juillet dernier.	Fifteen of these rocks are attributed to the meteorite shower last July.
Les prix de certaines roches, très rares sur Terre, vont jusqu’à de 11 000 à 22 500 $ l’once, soit environ dix fois le prix de l’or.	Some of the rocks, which are very rare on Earth, are being sold from US$11,000 to $22,500 per ounce, which is about ten times more than the cost of gold.
L’énergie noire est une force totalement invisible qui agit constamment sur l’univers.	Dark energy is a completely invisible force that is constantly acting upon the universe.
Son existence n’est connue qu’à cause de ses effets sur l’expansion de l’univers.	Its existence is known only because of its effects on the expansion of the universe.
Les scientifiques ont découvert des reliefs parsemés sur toute la surface de la lune, appelés escarpements lobés, qui résulteraient apparemment du fait que la lune rétrécisse progressivement.	Scientists have discovered landforms littered across the moon's surface called lobate scarps that have apparently resulted from the moon's shrinking very slowly.
Ces escarpements ont été trouvés sur toute la surface de la lune et semblent être très peu altérés, ce qui indique que les phénomènes géologiques qui les ont créés sont assez récents.	These scarps were found all over the moon and appear to be minimally weathered, indicating that the geologic events that created them were fairly recent.
Cette théorie remet en question l'affirmation selon laquelle la Lune ne connaîtrait absolument aucune activité géologique.	This theory contradicts the claim that the moon is completely devoid of geologic activity.
« Il va se comporter comme l’eau. Il est transparent comme l’eau.	"It's going to behave like water. It's transparent just the way water is.
Donc, si vous vous teniez près du rivage, vous seriez en mesure de voir tout au fond jusqu'aux cailloux ou autres boues qui se trouvent dans les profondeurs.	So if you were standing by the shoreline, you would be able to see down to whatever pebbles or gunk that was on the bottom.
Pour autant que nous sachions, il n’y a qu’un seul corps planétaire qui montre plus de dynamisme que Titan, et il s’agit de la Terre », ajouta Stofan.	As far as we know, there is only one planetary body that displays more dynamism than Titan, and its name is Earth," added Stofan.
L'orbiteur lunaire télécommandé Chandrayaan-1 a éjecté sa sonde d'impact lunaire (MIP), qui a foncé vers la surface de la Lune à 1,5 kilomètres par seconde (3000 miles par heure) et effectué un atterrissage forcé réussi près du pôle sud de la Lune.	The unmanned lunar orbiter Chandrayaan-1 ejected its Moon Impact Probe (MIP), which hurtled across the surface of the Moon at 1.5 kilometres per second (3000 miles per hour), and successfully crash landed near the Moon's south pole.
En plus de contenir trois instruments scientifiques importants, la sonde lunaire arborait également l'image du drapeau national indien, peint sur toutes ses faces.	Besides carrying three important scientific instruments, the lunar probe also carried the image of the Indian national flag, painted on all sides.
Alexeï Leonov, également connu sous le nom de « cosmonaute n° 11 », faisait partie de l'équipe originale des cosmonautes de l'Union soviétique.	Leonov, also known as "cosmonaut No. 11", was part of the Soviet Union's original team of cosmonauts.
Le 18 mars 1965, il a effectué la première activité extravéhiculaire habitée, ou « sortie dans l'espace », restant seul à l'extérieur du vaisseau spatial pendant un peu plus de douze minutes.	On March 18, 1965, he performed the first manned extravehicular activity (EVA), or "spacewalk", remaining alone outside the spacecraft for just over twelve minutes.
Il a reçu pour son travail le « Héros de l’Union Soviétique », la plus haute distinction de l’Union Soviétique.	He received the "Hero of the Soviet Union", the Soviet Union's highest honor, for his work.
Dix ans plus tard, il dirigeait la partie soviétique de la mission Apollo-Soyouz, symbolisant la fin de la course à l'espace.	Ten years later, he led the Soviet part of the Apollo–Soyuz mission symbolizing that the Space Race was over.
La station a maintenu son attitude, malgré la perte d'un gyroscope plus tôt au cours de la mission de la station spatiale, jusqu'à la fin de la sortie spatiale.	The station maintained its attitude, despite the loss of a gyroscope earlier in the space station mission, until the end of the spacewalk.
Chiao et Shaipov ont déclaré avoir observé une distance de sécurité par rapport aux propulseurs de contrôle d'attitude.	Chiao and Sharipov reported being a safe distance from the attitude adjustment thrusters.
La tour de contrôle russe a activé les jets, ce qui a permis à la station de retrouver une attitude normale.	Russian ground control activated the jets and normal attitude of the station was regained.
Selon les données de la carte internationale des tremblements de terre de l’Institut d'études géologiques des États-Unis, aucun tremblement de terre n’a eu lieu en Islande au cours de la semaine précédente.	The United States Geological Survey international earthquake map showed no earthquakes in Iceland in the week prior.
Par ailleurs, selon le bureau météorologique islandais, la région de Hekla n’a pas connu de tremblement de terre au cours des dernières 48 heures.	The Icelandic Meteorological Office also reported no earthquake activity in the Hekla area in the past 48 hours.
L'important tremblement de terre ayant entraîné le changement de phase a eu lieu le 10 mars sur la face nord-est de la caldeira du sommet du volcan.	The significant earthquake activity resulting in the phase change had took place on March 10 on the northeast side of the volcano's summit caldera.
Des nuages sombres sans rapport avec une quelconque activité volcanique ont été signalés à la base de la montagne.	Dark clouds unrelated to any volcanic activity were reported at the base of the mountain.
Les nuages présentaient un risque de confusion quant à savoir si une véritable éruption avait eu lieu.	The clouds presented the potential for confusion as to whether an actual eruption had taken place.
L'aiguille en acier reste immergée à cause de la tension à la surface.	The steel needle floats on top of the water because of surface tension.
La tension de la surface se crée parce que le magnétisme entre les molécules d'eau à la surface est tellement plus fort qu'avec les molécules d'air au dessus d'elles.	Surface tension happens because the water molecules at the surface of the water are strongly attracted to each other more than they are to the air molecules above them.
Les molécules d'eau forment une pellicule invisible à la surface qui permet à des objets comme l'aiguille de flotter sur l'eau.	The water molecules make an invisible skin on the water’s surface that allows things like the needle to float on top of the water.
Avec le passage du 400 mètres au 800 mètres, la vitesse devient beaucoup moins importante et l’endurance devient une nécessité absolue.	With the change from the quarter to the half mile run, speed becomes of much less importance and endurance becomes an absolute necessity.
Bien sûr, un excellent coureur de demi-fond, un homme capable de battre un record de deux minutes doit posséder une bonne pointe de vitesse, mais surtout une endurance parfaitement cultivée.	Of course a first-class half-miler, a man who can beat two minutes, must be possessed of a fair amount of speed, but endurance must be cultivated at all hazards.
Un peu de cross-country en hiver, combiné à un travail en salle pour la partie supérieure du corps, est la meilleure préparation pour la saison de course.	Some cross country running during the winter, combined with gymnasium work for the upper part of the body, is the best preparation for the running season.
De bonnes pratiques nutritionnelles ne suffisent pas à elles seules à garantir des performances d'élite, mais elles peuvent avoir un impact significatif sur le bien-être général des jeunes athlètes.	Proper nutritional practices alone cannot generate elite performances, but they can significantly affect young athletes' overall wellness.
Le maintien d'un bon équilibre énergétique, une hydratation adéquate et régulière et de bonnes connaissances concernant les différents aspects liés aux suppléments nutritionnels peuvent aider les athlètes à améliorer leurs performances et à se faire encore davantage plaisir dans le cadre de leur pratique sportive.	Maintaining a healthy energy balance, practicing effective hydration habits, and understanding the various aspects of supplementation practices can help athletes improve their performance and increase their enjoyment of the sport.
Le demi-fond est un sport relativement peu coûteux. L'idée qu'il nécessiterait un équipement basique est aussi fausse que la plupart des mythes qui entourent ce sport.	Middle distance running is a relatively inexpensive sport; however, there are many misconceptions regarding the few pieces of equipment required to participate.
Les produits peuvent être achetés si le besoin se fait sentir, mais la plupart n'auront que peu ou aucune incidence réelle sur la performance de l'athlète.	Products can be purchased as needed, but most will have little or no real impact on performance.
Les athlètes peuvent avoir le sentiment qu'ils préfèrent un produit même si celui-ci n'apporte aucun réel avantage.	Athletes may feel that they prefer a product even when it provides no real benefits.
L'atome peut être considéré comme étant l'une des unités qui constitue toute matière.	The atom can be considered to be one of the fundamental building blocks of all matter.
Il s’agit d’une entité très complexe qui consiste, selon un modèle de Bohr simplifié, en un noyau central orbité par des électrons, un peu comme les planètes en orbite autour du soleil — cf. illustration 1.1.	Its a very complex entity which consists, according to a simplified Bohr model, of a central nucleus orbited by electrons, somewhat similar to planets orbiting the sun - see Figure 1.1.
Le noyau est constitué de deux particules — des neutrons et des protons.	The nucleus consists of two particles - neutrons and protons.
Les protons ont une charge électrique positive tandis que les neutrons n'ont pas de charge. Les électrons ont une charge électrique négative.	Protons have a positive electric charge while neutrons have no charge. The electrons have a negative electric charge.
Avant d'examiner la victime, assurez-votre sécurité en inspectant les lieux.	To Check the victim, you must first survey the scene to ensure your safety.
Vous devez remarquer la position de la victime lorsque vous vous approchez d'elle et tout signal d'alerte manifeste.	You need to notice the victim's position as you approach him or her and any automatic red flags.
Si vous vous blessez en essayant d'aider, vous ne ferez qu'empirer les choses.	If you get hurt trying to help, you may only serve to make matters worse.
L'étude a révélé que la dépression, la peur et le catastrophisme étaient à l'origine de la relation entre la douleur et le handicap chez les personnes souffrant de douleurs au bas du dos.	The study found that depression, fear and catastrophising mediated the relationship between pain and disability in lower back pain sufferers.
Seuls les effets de la catastrophe, et non la dépression et la peur, étaient conditionnés par des séances hebdomadaires régulières et structurées d'AP.	Only the effects of catastrophizing, not depression and fear was conditional of regular weekly structured PA sessions.
Ceux qui participent à une activité régulière ont besoin de plus de soutien en termes de perception négative de la douleur, en distinguant les différences entre la douleur chronique et la sensation d'inconfort et le mouvement physique normal.	Those participating in regular activity required more support in terms of negative perception of pain distinguishing the differences of chronic pain and discomfort feel from normal physical movement.
La vision, ou la capacité de voir, dépend du système visuel, des organes sensoriels ou des yeux.	Vision, or the ability to see depends on visual system sensory organs or eyes.
Les anatomies oculaires varient. Elles sont classées par ordre de complexité en fonction des exigences de l'organisme.	There are many different constructions of eyes, ranging in complexity depending on the requirements of the organism.
Les diverses constructions ont des capacités différentes, sont sensibles à des longueurs d’onde distinctes et ont des degrés d’acuité différents. Elles nécessitent également des traitements distincts pour l’interprétation des données reçues et les nombres qu’il leur faut pour fonctionner de manière optimale diffèrent aussi.	The different constructions have different capabilities, are sensitive to different wave-lengths and have differing degrees of acuity, also they require different processing to make sense of the input and different numbers to work optimally.
Une population est l'ensemble des organismes d'une espèce particulière dans une zone géographique donnée.	A population is the collection of organisms of a particular species within a given geographic area.
Lorsque tous les individus d'une population sont identiques en ce qui concerne un trait phénotypique particulier, on dit qu'ils sont monomorphes.	When all individuals in a population are identical with regard to a particular phenotypic trait they are known as monomorphic.
Lorsque les individus présentent plusieurs variantes d'un trait particulier, ils sont polymorphes.	When the individuals show several variants of a particular trait they are polymorphic.
Les colonies de fourmis de l’armée marchent et nichent également dans différentes phases.	Army ant colonies march and nest in different phases as well.
Durant la période nomade, les fourmis légionnaires marchent la nuit et s'arrêtent pour camper le jour.	In the nomadic phase, army ants march at night and stop to camp during the day.
La colonie entame une phase nomade lorsque la nourriture disponible a diminué. Pendant cette phase, la colonie construit des nids temporaires qui sont changés tous les jours.	The colony begins a nomadic phase when available food has decreased. During this phase, the colony makes temporary nests that are changed everyday.
Chacun de ces raids ou chacune de ces razzias dure environ 17 jours.	Each of these nomadic rampages or marches lasts for approximately 17 days.
Qu’est-ce qu’une cellule ? Le mot « cellule » vient du mot latin « cella », qui signifie « petite pièce », et a été inventé par un microscopiste qui observait la structure du liège.	What is a cell? The word cell comes from the Latin word "cella", meaning "small room", and it was first coined by a microscopist observing the structure of cork.
La cellule est l'unité de base de tous les êtres vivants, et tous les organismes sont composés d'une ou plusieurs cellules.	The cell is the basic unit of all living things, and all organisms are composed of one or more cells.
Dans l'étude du vivant, les cellules sont tellement essentielles qu'on les considère bien souvent comme les fondamentaux de la vie.	Cells are so basic and critical to the study of life, in fact, that they are often referred to as "the building blocks of life".
Le système nerveux maintient l’homéostasie en envoyant des impulsions nerveuses à travers le corps pour maintenir le flux sanguin aussi bien en marche que non perturbé.	The Nervous System maintains homeostasis by sending nerve impulses through out the body to keep the flow of blood going as well as undisturbed.
Ces impulsions nerveuses peuvent être envoyées très rapidement dans tout le corps, ce qui contribue à le protéger contre toute menace potentielle.	These nerve impulses can be sent so quickly throughout the body which helps keep the body safe from any potential threat.
Les tornades frappent une petite zone par rapport à d’autres tempêtes violentes, mais elles peuvent tout détruire sur leur passage.	Tornadoes strike a small area compared to other violent storms, but they can destroy everything in their path.
Les tornades déracinent les arbres, arrachent les planches des bâtiments et projettent les voitures dans le ciel. Les deux pour cent de tornades les plus violentes durent plus de trois heures.	Tornadoes uproot trees, rip boards from buildings, and fling cars up into the sky. The most violent two percent of tornadoes last more than three hours.
Ces tempêtes géantes comporte des vents soufflant jusqu'à 480 km/h (133 m/s ou 300 mph).	These monster storms have winds up to 480 km/h (133 m/s; 300 mph).
L'homme fabrique et utilise des lentilles pour l'agrandissement depuis des milliers et des milliers d'années.	Humans have been making and using lenses for magnification for thousands and thousands of years.
Toutefois, les premiers vrais télescopes furent fabriqués en Europe à la fin du XVIe siècle.	However, the first true telescopes were made in Europe in the late 16th century.
Ces télescopes utilisaient une combinaison de deux lentilles afin que les objets distants paraissent à la fois plus gros et plus proches.	These telescopes used a combination of two lenses to make distant objects appear both nearer and larger.
L’avidité et l’égoïsme feront toujours partie de nous. Il est naturel dans un rapport de coopération de gagner plus et rapidement, en agissant avec égoïsme, lorsque la majorité est avantagée.	Greed and selfishness will always be with us and it is the nature of cooperation that when the majority benefit there will always be more to gain in the short term by acting selfishly
Il est à espérer que la plupart des gens réaliseront que leur meilleure option à long terme est de travailler ensemble.	Hopefully, most people will realise that their long term best option is to work together with others.
Les scientifiques affirment que l'explosion causée par la collision a été massive.	Scientists say the explosion caused by the collision was massive.
On essaie encore de déterminer quelle a été l'ampleur de l'accident et comment la Terre sera affectée.	They are still trying to determine just how large the crash was and how the Earth will be affected.
Le commandement stratégique du bureau du département de la défense des États-Unis suit les débris.	The United States Strategic Command of the U.S. Department of Defense office is tracking the debris.
Le résultat de l'analyse du tracé sera publié sur un site Web public.	The result of plotting analysis will be posted to a public website.
Toutes les entrées des grottes, qui ont été baptisées « Les sept sœurs », ont un diamètre d’au moins 100 à 250 mètres.	All of the cave entrances, which were named "The Seven Sisters", are at least 100 to 250 meters (328 to 820 feet) in diameter.
Les images infrarouges révèlent, au vu des variations de température le jour et la nuit, qu’il s’agit sans doute de grottes.	Infrared images show that the temperature variations from night and day show that they are likely caves.
« Ils sont plus frais que la surface environnante le jour et plus chauds la nuit ».	"They are cooler than the surrounding surface in the day and warmer at night.
« Leur comportement thermique n’est pas aussi stable que celui des grandes grottes de la planète qui maintiennent une température constante, mais ils se ressemblent en ce qu’ils sont des trous profonds dans la terre », selon Glen Cushing, membre de l’équipage de l'USGS (Centre américain d’études géologiques) et du personnel de l’Université d’Arizona du Nord situé à Flagstaff, en Arizona.	Their thermal behavior is not as steady as large caves on Earth that often maintain a fairly constant temperature, but it is consistent with these being deep holes in the ground," said Glen Cushing of the United States Geological Survey (USGS) Astrogeology Team and of Northern Arizona University located in Flagstaff, Arizona.
L'ASUS Eee PC, lancé précédemment à l'échelle mondiale pour des raisons d'économies et de fonctionnalités, est devenu un sujet brûlant lors du Taipei IT Month de 2007.	ASUS Eee PC, earlier launched world-wide for cost-saving and functionality factors, became a hot topic in 2007 Taipei IT Month.
Mais le marché des ordinateurs portables sera profondément bouleversé et diversifié après qu'ASUS se soit vu récompenser du prix Taiwan Sustainable Award 2007 décerné par le Yuan exécutif de la République de Chine.	But the consumer market on laptop computer will be radically varied and changed after ASUS was awarded in the 2007 Taiwan Sustainable Award by Executive Yuan of the Republic of China.
Environ trois minutes après le lancement, une caméra embarquée montrait de nombreux morceaux de mousse isolante en train de se détacher du réservoir de carburant.	Around 3 minutes into the launch, an on-board camera showed numerous pieces of insulation foam break away from the fuel tank.
On ne pense cependant pas qu'ils aient causé le moindre dégât à la navette.	However, they are not thought to have caused any damage to the shuttle.
Le chef du programme de la navette de la NASA, N. Wayne Hale Jr., a dit que la mousse était tombée « après le temps qui nous préoccupe ».	NASA's shuttle program chief N. Wayne Hale Jr. said the foam had fallen "after the time we are concerned about."
Environ 60 cas de surchauffe d’iPods défectueux ont été signalés, provoquant au total six incendies et laissant quatre personnes avec des brûlures mineures.	Around 60 cases of malfunctioning iPods overheating have been reported, causing a total of six fires and leaving four people with minor burns.
Le ministère japonais de l'économie, du commerce et de l'industrie (METI) a déclaré qu'il avait eu connaissance de 27 accidents liés à ces appareils.	Japan's Ministry of Economy, Trade and Industry (METI) said that it had been aware of 27 accidents related to the devices.
La semaine dernière, le METI a annoncé qu’Apple l’avait informé de 34 incidents de surchauffe supplémentaires, que la société a qualifiés de « non graves ».	Last week, METI announced that Apple had informed it of 34 additional overheating incidents, which the company called "non-serious."
Le ministère a réagi en qualifiant de « vraiment regrettable » l'ajournement du rapport par Apple.	The ministry responded by calling Apple's postponement of the report "truly regrettable."
Liggins a suivi les traces de son père et s'est lancé dans une carrière de médecin.	Liggins followed in his father’s footsteps and entered a career in medicine.
Il a suivi une formation d'obstétricien, et a commencé à travailler au National Women's Hospital d'Auckland en 1959.	He trained as an obstetrician and began to work at the Auckland's National Women's Hospital in 1959.
Lorsqu'il travaillait à l'hôpital, Liggins a commencé à enquêter sur les accouchements prématurés pendant son temps libre.	While he was working at the hospital Liggins began to investigate premature labor during his spare time.
Ses recherches ont démontré que si une hormone était administrée, elle accélérerait la maturation pulmonaire du bébé.	His research showed that if a hormone was administered it would speed up the baby's foetal lung maturation.
Curtis Cooper, mathématicien et professeur d'informatique à la University of Central Missouri, a découvert le 25 janvier le plus grand nombre premier connu à ce jour.	Curtis Cooper, a mathematician and computer science professor at the University of Central Missouri, has discovered the largest known prime number to date on January 25.
Plusieurs personnes ont vérifié la découverte à l'aide de différents matériels et logiciels au début du mois de février, et elle a été annoncée mardi.	Several people verified the discovery using different hardware and software by the beginning of February and it was announced on Tuesday.
Les comètes ont peut-être été une source d'approvisionnement en eau pour la terre, ainsi qu'en matière organique qui peut former des protéines et favoriser la vie.	Comets may possibly have been a source of water delivery to the earth along with organic matter that can form proteins and support life.
Les scientifiques espèrent comprendre comment les planètes se forment, et plus particulièrement comment la Terre s'est formée, puisque des comètes sont entrées en collision avec elle il y a longtemps.	Scientists hope to understand how planets form, especially how the Earth formed, since comets collided with the Earth long ago.
Une étude publiée jeudi dans la revue Science a fait état de la genèse d'une nouvelle espèce d'oiseau dans les îles Galápagos équatoriennes.	A study published on Thursday in the journal Science reported on formation of a new bird species on the Ecuadorean Galápagos Islands.
Des chercheurs de l'université de Princeton aux États-Unis et de l'université d'Uppsala en Suède ont indiqué que la nouvelle espèce avait évolué en seulement deux générations, bien que ce processus ait été estimé beaucoup plus long, suite à la reproduction entre un pinson de Darwin endémique, Geospiza fortis, et le pinson immigrant à bec conique, Geospiza conirostris.	Researchers from Princeton University in the United States and Uppsala University in Sweden reported the new species evolved in just two generations, though this process had been believed to take much longer, due to breeding between an endemic Darwin finch, Geospiza fortes, and the immigrant cactus finch, Geospiza conirostris.
C'est ce qu'on appelle le pH d'un produit chimique. Vous pouvez fabriquer un indicateur en utilisant du jus de chou rouge.	This is called a chemical's pH. You can make an indicator using red cabbage juice.
Le jus de chou change de couleur en fonction de l’acidité ou de la basicité (alcalinité) du produit chimique.	The cabbage juice changes color depending on how acidic or basic (alkaline) the chemical is.
Le niveau de pH est indiqué par la quantité d'ions d'hydrogène (le H dans le pH) présents dans le produit chimique testé.	The pH level is indicated by the amount of Hydrogen (the H in pH) ions in the tested chemical.
Les ions d'hydrogène sont des protons qui ont été dépouillés de leur électron (puisque les atomes d'hydrogène sont constitués d'un proton et d'un électron).	Hydrogen ions are protons that had their electrons stripped off them (since Hydrogen atoms consist of one proton and one electron).
Mélangez les deux poudres sèches ensemble, puis, avec les mains propres et humides, pressez-les en une boule.	Swirl the two dry powders together and then, with clean wet hands, squeeze them into a ball.
L'humidité sur vos mains va réagir avec les couches extérieures, ce qui induira une sensation étrange et produira une sorte de coquille.	The moisture on your hands will react with the outer layers, which will feel funny and form a sort of shell.
Pratiquement tous les ordinateurs utilisés aujourd'hui sont basés sur la manipulation d'informations qui sont codées sous forme de nombres binaires.	Virtually all computers in use today are based on the manipulation of information which is coded in the form of binary numbers.
Un nombre binaire ne peut avoir qu’une seule de deux valeurs : 0 ou 1. Ces nombres sont appelés des chiffres binaires, ou bits pour utiliser le jargon informatique.	A binary number can have only one of two values, i.e. 0 or 1, and these numbers are referred to as binary digits - or bits, to use computer jargon.
Un empoisonnement interne peut ne pas être visible immédiatement. Les symptômes, tels que les vomissements, sont suffisamment généraux pour qu'un diagnostic immédiat ne puisse pas être posé.	Internal poisoning may not be immediately apparent. Symptoms, such as vomiting are sufficiently general that an immediate diagnosis cannot be made.
Le meilleur indice d'un empoisonnement interne est probablement la présence d'un récipient ouvert de médicaments ou de produits chimiques domestiques toxiques.	The best indication of internal poisoning may be the presence of an open container of medication or toxic household chemicals.
Consultez l'étiquette pour connaître les instructions de premiers secours spécifiques à ce poison.	Check the label for specific first aid instructions for that specific poison.
Le terme « insecte » est utilisé par les entomologistes dans un sens formel pour ce groupe d’insectes.	The term bug is used by entomologists in a formal sense for this group of insects.
Ce terme dérive d’une ancienne familiarité avec les punaises de lit, qui sont des insectes très adaptés pour parasiter les humains.	This term derives from ancient familiarity with Bed-bugs, which are insects highly adapted to parasitize humans.
Les réduves, tout comme les punaises de lit, sont nidicoles, c'est-à-dire adaptées pour vivre dans le nid ou l'habitat de leur hôte.	Both Assassin-bugs and Bed-bugs are nidicolous, adapted to living in nest or housing of their host.
Aux États-Unis, il y a environ 400 000 cas connus de sclérose en plaques (SEP), ce qui en fait la principale maladie neurologique chez les jeunes et les adultes d’âge moyen.	Across the United States of America, there are approximately 400,000 known cases of Multiple Sclerosis (MS), leaving it as the leading neurological disease in younger and middle aged adults.
La sclérose en plaques est une maladie qui affecte le système nerveux central, composé du cerveau, de la moelle épinière et du nerf optique.	MS is a disease that affects the central nervous system, which is made up of the brain, the spinal cord and the optic nerve.
Des recherches ont montré que les femmes sont deux fois plus susceptibles d’avoir la sclérose en plaques que les hommes.	Research has found that females are two times more likely to have MS then males.
Un couple peut très bien estimer qu'il n'est pas dans leur intérêt, ni dans celui de l'enfant, de s'occuper de l'éducation d'un bébé.	A couple may decide it is not in their best interest, or in the interest of their child, to raise a baby.
Ces couples peuvent choisir de faire un projet d’adoption pour leur bébé.	These couples may choose to make an adoption plan for their baby.
Dans le cadre d'une adoption, les parents biologiques mettent fin à leurs droits parentaux afin qu'un autre couple puisse élever l'enfant.	In an adoption, the birth parents terminate their parental rights so that another couple may parent the child.
L'objectif principal de la science est de comprendre la façon dont le monde fonctionne grâce à la méthode scientifique. Cette méthode guide en fait la plupart des recherches scientifiques.	Science’s main goal is to figure out the way the world works through the scientific method. This method in fact guides most scientific research.
Ce n'est cependant pas la seule, l'expérimentation, et une expérience est un test qui sert à éliminer une ou plusieurs des hypothèses possibles, poser des questions et faire des observations, mais qui oriente également la recherche scientifique.	It isn’t alone though, experimentation, and an experiment is a test that is used to eliminate one or more of the possible hypotheses, asking questions, and making observations also guide scientific research.
Les naturalistes et les philosophes se sont concentrés sur les textes anciens, et en particulier sur la Bible en latin.	Naturalists and philosophers focused on classical texts and, in particular, on the Bible in Latin.
Les opinions d'Aristote sur toutes les questions scientifiques, y compris la psychologie, ont été acceptées.	Accepted were Aristotle's views on all matters of science, including psychology.
Avec le déclin de la connaissance du grec, l'Occident s'est retrouvé coupé de ses racines philosophiques et scientifiques grecques.	As knowledge of Greek declined, the West found itself cut off from its Greek philosophical and scientific roots.
De nombreux rythmes observés dans la physiologie et le comportement dépendent souvent en grande partie de la présence de cycles endogènes et de leur production par des horloges biologiques.	Many observed rhythms in physiology and behavior often crucially depend on the presence of endogenous cycles and their production through biological clocks.
Les rythmes périodiques, qui ne constituent pas simplement des réponses à des stimuli périodiques externes, ont été documentés pour la plupart des êtres vivants, y compris les bactéries, les champignons, les plantes et les animaux.	Periodic rhythms, which are not simply responses to external periodic cues, have been documented for most living beings, including bacteria, fungi, plants, and animals.
Les horloges biologiques sont des oscillateurs autosuffisants qui continueront un cycle de fonctionnement pendant une certaine période, même en l'absence de stimulation extérieure.	Biological clocks are self sustaining oscillators which will continue a period of free-running cycling even in the absence of external cues.
L'expérience Hershey et Chase a été l'une des principales indications que l'ADN était un matériel génétique.	The Hershey and Chase experiment was one of the leading suggestions that DNA was a genetic material.
Hershey et Chase ont utilisé des phages, ou des virus, pour implanter leur propre ADN dans une bactérie.	Hershey and Chase used phages, or viruses, to implant their own DNA into a bacterium.
Ils ont mené deux expériences pour marquer soit l’ADN du phage avec un phosphore radioactif, soit la protéine du phage avec du soufre radioactif.	They did two experiments marking either the DNA in the phage with a radioactive phosphorus or the protein of the phage with radioactive sulfur.
Les mutations peuvent avoir de nombreux effets différents selon le type de mutation, l'importance de la partie du matériel génétique affectée et si les cellules affectées sont des cellules germinales.	Mutations can have a variety of different effects depending on the type of mutation, the significance of the piece of genetic material affected and whether the cells affected are germ-line cells.
Seules les mutations des cellules germinales peuvent être transmises aux enfants, tandis que d'autres mutations peuvent entraîner la mort des cellules ou le cancer.	Only mutations in germ-line cells can be passed on to children, while mutations elsewhere can cause cell-death or cancer.
L'écotourisme intéresse les personnes désireuses de visiter des zones naturelles dans le but de profiter du paysage, notamment de la faune et de la flore.	Nature-based tourism attracts people interested in visiting natural areas for the purpose of enjoying the scenery, including plant and animal wildlife.
La chasse, la pêche, la photographie, l’observation des oiseaux, la visite de parcs et l’étude des informations sur l’écosystème sont des exemples d’activités sur place.	Examples of on-site activities include hunting, fishing, photography, bird watching, and visiting parks and studying information about the ecosystem.
On peut par exemple aller voir, photographier et découvrir les orang-outans de Bornéo.	An example is visiting, photographing, and learning about organgatuangs in Borneo.
Chaque matin, les gens quittent les petites villes de campagne en voiture pour se rendre à leur lieu de travail et croisent d'autres gens qui vont travailler dans la campagne qu'ils viennent de quitter.	Every morning, people leave small country towns in cars to go their workplace and are passed by others whose work destination is the place they have just left.
Dans cette navette de transport dynamique, chacun est en quelque sorte relié à un système de transport basé sur les voitures particulières et le soutient.	In this dynamic transport shuttle everyone is somehow connected with, and supporting, a transport system based on private cars.
La science montre désormais que cette économie massivement basée sur le carbone a délogé la biosphère de son état de stabilité qui a soutenu l'évolution humaine pendant deux millions d'années.	Science now indicates that this massive carbon economy has dislodged the biosphere from one of its stable states that has supported human evolution for the past two million years.
