Une fois la bataille pour la France terminée, l'Allemagne a commencé à se préparer à envahir l'île de Grande-Bretagne.	With the battle for France over, Germany began to get ready to invade the island of Britain.
L’Allemagne a donné le nom de code « Opération Lion de Mer » à cette attaque. L’armée britannique avait perdu la majeure partie de son artillerie lourde et de ses munitions lors de l’évacuation de Dunkerque, et était donc assez affaiblie.	Germany code-named the attack “Operation Sealion”. Most of the British Army's heavy weapons and supplies had been lost when it evacuated from Dunkirk, so the army was fairly weak.
Mais la Royal Navy était encore beaucoup plus forte que la marine allemande (« Kriegsmarine ») et aurait pu détruire toute flotte d'invasion envoyée à travers la Manche anglaise.	But the Royal Navy was still much stronger than the German Navy (“Kriegsmarine”) and could have destroyed any invasion fleet sent across the English Channel.
Cependant, très peu de navires de la Royal Navy étaient basés près des routes d'invasion probables car les amiraux craignaient d'être coulés par une attaque aérienne allemande.	However, very few Royal Navy ships were based near the likely invasion routes as the admirals were afraid they would be sunk by German air attack.
Commençons par expliquer la stratégie de l'Italie, « dauphin » principal de l'Allemagne et du Japon.	Let's start with an explanation about Italy's plans. Italy was mainly the "little brother" of Germany and Japan.
Leur armée et leur flotte étaient plus faibles, et ce malgré le fait qu’ils aient construit quatre nouveaux navires juste avant le début de la guerre.	It had a weaker army and a weaker navy, although they had just built four new ships right before the beginning of the war.
Les principaux objectifs de l'Italie étaient les pays africains. Pour conquérir ces pays, il fallait disposer d'une base de lancement des troupes, afin que celles-ci puissent traverser la Méditerranée et envahir l'Afrique.	Italy's main goals were African countries. To capture those countries, they would need to have a troop launching pad, so as troops could sail across the Mediterranean Sea and invade Africa.
Pour cela, ils devaient se débarrasser des bases et des navires britanniques en Égypte. En dehors de ces actions, les cuirassés italiens n'étaient pas censés faire quoi que ce soit d'autre.	For that, they had to get rid of British bases and ships in Egypt. Besides those actions, Italy's battleships were not supposed to do anything else.
Passons maintenant au Japon. Le Japon est un pays insulaire, tout comme la Grande-Bretagne.	Now for Japan. Japan was an island country, just like Britain.
Les sous-marins sont des navires conçus pour voyager sous l'eau et y rester pendant une longue période.	Submarines are ships designed to travel underwater, and remain there for an extended amount of time.
Les sous-marins ont été utilisés pendant la Première et la Deuxième Guerre mondiale. À l’époque, ils étaient très lents et avaient une portée de tir très limitée.	Submarines were used in World War I and World War II. Back then they were very slow and had a very limited shooting range.
Au début de la guerre, ils voguaient essentiellement sur la mer. Mais au vu des progrès réalisés en matière de radars, et étant donné leur précision sans cesse grandissante, les sous-marins étaient obligé de passer sous l'eau pour ne pas être repérés.	In the beginning of the war they mostly travelled on top of the sea, but as radar began developing and becoming more accurate the submarines were forced to go under water to avoid being seen.
Les sous-marins allemands étaient appelés U-Boot. Les Allemands étaient très doués pour la navigation et le maniement de leurs sous-marins.	German submarines were called U-Boats. The Germans were very good at navigating and operating their submarines.
En raison de leur succès avec les sous-marins, après la guerre on ne fait pas confiance aux Allemands pour qu'ils en possèdent beaucoup.	Because of their success with submarines, after the war Germans aren't trusted to have many of them.
Au lendemain de son indépendance, Singapour a acquis une expertise dans le domaine des jardins botaniques. Cet Etat insulaire s'est par la suite transformé en une cité jardin de type tropical.	Early in the nation's independence, Singapore Botanic Gardens' expertise helped to transform the island into a tropical Garden City.
En 1981, Vanda Miss Joaquim, un hybride d'orchidée, a été choisie comme fleur emblème de la nation.	In 1981, Vanda Miss Joaquim, an orchid hybrid, was chosen as the nation's national flower.
Chaque année, vers le mois d’octobre, près de 1,5 million d’herbivores se dirigent vers les plaines du sud, en traversant la rivière Mara, depuis les collines du nord pour les pluies.	Every year around October nearly 1.5 million herbivores travel towards the southern plains, crossing the Mara River, from the northern hills for the rains.
Et puis retour au nord par l'ouest, en traversant une fois de plus la rivière Mara, après les pluies aux environs d'avril.	And then back to the north through the west, once again crossing the Mara river, after the rains in around April.
La région du Serengeti comprend le parc national du Serengeti, la zone de conservation de Ngorongoro et la réserve de chasse des Maswa en Tanzanie, ainsi que la réserve nationale du Masai Mara au Kenya.	The Serengeti region contains the Serengeti National Park, the Ngorongoro Conservation Area and Maswa Game Reserve in Tanzania and the Maasai Mara National Reserve in Kenya.
Les choses prirent une mauvaise tournure pour les Italiens en Afrique du Nord quasiment dès le début. Une semaine après la déclaration de guerre de l’Italie le 10 juin 1940, les 11e hussards britanniques s’emparèrent du Fort Capuzzo en Libye.	Things did not go well for the Italians in North Africa almost from the start. Within a week of Italy's declaration of war on June 10, 1940, the British 11th Hussars had seized Fort Capuzzo in Libya.
Dans une embuscade à l'est de Bardia, les Britanniques ont capturé l'ingénieur en chef de la dixième armée italienne, le général Lastucci.	In an ambush east of Bardia, the British captured the Italian Tenth Army's Engineer-in-Chief, General Lastucci.
Le 28 juin, le maréchal Italo Balbo, gouverneur général de Libye et successeur potentiel de Mussolini, fut tué par un tir ami alors qu'il atterrissait à Tobrouk.	On June 28, Marshal Italo Balbo, the Governor-General of Libya and apparent heir to Mussolini, was killed by friendly fire while landing in Tobruk.
Le débarquement du jour J et les batailles suivantes ont libéré le nord de la France, mais le sud n'était toujours pas libre.	The D-Day landings and the following battles had freed the north of France, but the south still wasn't free.
Elle était gouvernée par les Français de Vichy, des Français qui ont fait la paix avec les Allemands en 1940 et ont collaboré avec l'occupant au lieu de l'affronter.	It was ruled by the "Vichy" French. These were French people who had made peace with the Germans in 1940 and worked with the invaders instead of fighting them.
Le 15 août 1940, les Alliés débarquèrent dans le sud de la France, une invasion appelée Opération « Dragoon ».	On 15 August 1940, the Allies invaded southern France, the invasion was called "Operation Dragoon".
En à peine deux semaines, les Américains et les Forces de la France Libre avaient libéré le sud de la France et se dirigeaient vers l'Allemagne.	In just two weeks the Americans and Free French forces had liberated southern France and were turning towards Germany.
Le Machu Picchu est composé de trois structures principales, à savoir l'Intihuatana, le temple du soleil et la salle des trois fenêtres.	Machu Picchu consist of three main structures, namely Intihuatana, the Temple of the Sun, and the Room of the Three Windows.
La plupart des bâtiments limitrophes du complexe ont été reconstruits afin d'offrir aux touristes un meilleur aperçu de leur aspect originel.	Most of the buildings on the edges of the complex have been rebuilt in order to give tourists a better idea of how they originally appeared.
En 1976, trente pour cent du Machu Picchu avait été restauré et cette restauration se poursuit jusqu'à aujourd'hui.	By 1976, thirty percent of Machu Picchu had been restored and restoration continues till today.
Le 17 septembre 1939, la défense polonaise était déjà brisée, et le seul espoir était de battre en retraite et de se réorganiser le long de la tête de pont roumaine.	By September 17, 1939, the Polish defense was already broken, and the only hope was to retreat and reorganise along the Romanian bridgehead.
Mais ces plans sont devenus obsolètes presque du jour au lendemain, quand plus de 800 000 soldats de l’Armée rouge de l’Union soviétique sont arrivés et ont créé le front biélorusse et ukrainien après avoir envahi les régions est de la Pologne, violant ainsi le Traité de Paix de Riga, le pacte de non-agression soviéto-polonais, ainsi que d’autres traités internationaux, qu’ils soient bilatéraux ou multilatéraux.	However, these plans were rendered obsolete nearly overnight, when over 800,000 soldiers from the Soviet's Union Red Army entered and created the Belarussian and Ukrainian fronts after invading the eastern regions of Poland in violation of the Riga Peace Treaty, the Soviet-Polish Non-Aggression Pact, and other international treaties, both bilateral and multilateral.
Bien que la construction de pyramides en pierre se soit poursuivie jusqu'à la fin de l'Ancien Empire, les pyramides de Gizeh n'ont jamais été surpassées par leur taille et l'excellence technique de leur construction.	Although pyramid-building in stone continued until the end of the Old Kingdom, the pyramids of Giza were never surpassed in their size and the technical excellence of their construction.
Les Égyptiens antiques du Nouvel Empire étaient émerveillés par les monuments de leurs prédécesseurs, qui avaient alors bien plus de mille ans.	New Kingdom ancient Egyptians marvelled at their predecessors monuments, which were then well over a thousand year old.
