"Панамские документы" — это собирательное название приблизительно десяти миллионов документов панамской юридической фирмы Mossack Fonseca, просочившихся в прессу весной 2016 г.	"Panama Papers" is an umbrella term for roughly ten million documents from Panamanian law firm Mossack Fonseca, leaked to the press in spring 2016.
Документы показали, что четырнадцать банков помогли состоятельным клиентам спрятать миллиарды долларов США, чтобы избежать уплаты налогов и выполнения прочих нормативных требований.	The documents showed fourteen banks helped wealthy clients hide billions of US dollars of wealth to avoid taxes and other regulations.
Британская газета The Guardian  предположила, что Deutsche Bank контролировал примерно треть из 1200 подставных компаний, использованных для этой цели.	British newspaper The Guardian suggested Deutsche Bank controlled roughly a third of the 1200 shell companies used to accomplish this.
По всему миру происходили протесты, было несколько уголовных преследований, а главы правительств Исландии и Пакистана ушли в отставку.	There were protests worldwide, several criminal prosecutions, and the leaders of the governments of Iceland and Pakistan both resigned.
Иракская тюрьма Абу-Грейб была подожжена во время бунта.	Iraq's Abu Ghraib prison has been set alight during a riot.
Тюрьма получила скандальную известность после раскрытия издевательств над заключенными, происходивших в ней, когда она перешла под контроль американских военных.	The jail became notorious after prisoner abuse was discovered there after US forces took over.
Пике-младший попал в аварию на Гран-при Сингапура в 2008 году сразу после раннего пит-стопа Фернандо Алонсо, после чего пришлось задействовать машину безопасности.	Piquet Jr. crashed in the 2008 Singapore Grand Prix just after an early pit stop for Fernando Alonso, bringing out the safety car.
Когда машины впереди Алонсо отправились за топливом под машину безопасности, он двинулся вверх, чтобы взять победу.	As the cars ahead of Alonso went in for fuel under the safety car, he moved up the pack to take victory.
Пике-младший не был допущен к гонкам после Гран-при Венгрии 2009 года.	Piquet Jr. was sacked after the 2009 Hungarian Grand Prix.
За последние 3 месяца более 80 арестованных были освобождены из центра предварительного заключения без предъявления им официальных обвинений.	In the last 3 months, over 80 arrestees were released from the Central Booking facility without being formally charged.
В апреле этого года судья Глинн издал судебный запрет в отношении данного учреждения, чтобы освободить тех, кто содержался в неволе более 24 часов после их поступления в тюрьму, и у которых не были проведены слушания у уполномоченного суда.	In April this year, a temporary restaining order was issued by Judge Glynn against the facility to enforce the release of those held more than 24 hours after their intake who did not receive a hearing by a court commissioner.
Комиссар полиции устанавливает залог (на случай его внесения) и формализует обвинения, выдвинутые офицером, который выполнил арест. После этого обвинения заносятся в компьютерную систему штата, в которой ведется дело задержанного.	The commissioner sets bail, if granted, and formalizes the charges filed by the arresting officer. The charges are then entered into the state's computer system where the case is tracked.
На слушании также назначается срок, в течение которого должно быть соблюдено право подозреваемого на безотлагательное судебное разбирательство.	The hearing also marks the date for the suspect’s right to a speedy trial.
По сообщению информационного агентства ANSA, "полиция была обеспокоена парой заказных убийств высокопоставленных лиц, что, по мнению органов правопорядка, могло способствовать развязке полномасштабной войны за преемственность.	According to Ansa, "police were concerned by a couple of top-level hits they feared might spark a full-blown war of succession.
Полиция сказала, что Ло Пикколо был во главе, потому что он был правой рукой Провенцано в Палермо, и его больший опыт завоевал ему уважение старшего поколения боссов, поскольку они придерживались политики Провенцано, направленной на то, чтобы как можно меньше давать о себе знать и одновременно укреплять сеть своей власти.	Police said Lo Piccolo had the upper hand because he had been Provenzano's right-hand man in Palermo and his greater experience won him the respect of the older generation of bosses as they pursued Provenzano's policy of keeping as low as possible while strengthening their power network.
Эти боссы были усмирены Провензано, когда он положил конец войне с государством, начатой Рииной, в результате которой в 1992 году погибли крестоносцы мафии Джованни Фальконе и Паоло Борсельино.	These bosses had been reined in by Provenzano when he put an end to the Riina-driven war against the state that claimed the lives of Mafia crusaders Giovanni Falcone and Paolo Borsellino in 1992."
Бразилия является крупнейшей римско-католической страной в мире, и Римско-католическая церковь неизменно выступала против легализации однополых браков в стране.	Brazil is the largest Roman Catholic country on Earth, and the Roman Catholic Church has consistently opposed the legalization of same-sex marriage in the country.
Бразильский Национальный конгресс десять лет обсуждал легализацию  подобных гражданских браков, и теперь они допускаются по закону исключительно в Риу-Гранди-ду-Сул.	The National Congress of Brazil has debated legalization for 10 years, and such civil marriages are currently only legal in Rio Grande do Sul.
Оригинальный законопроект был разработан бывшим мэром Сан-Паулу Мартой Суплиси. Предлагаемый законопроект с внесёнными в него поправками теперь находится в руках Роберто Джефферсона.	The original bill was drafted by former mayor of São Paulo, Marta Suplicy. The proposed legislation, after being amended, is now in the hands of Roberto Jefferson.
Цель протестующих — собрать 1,2 миллиона подписей под петицией, чтобы представить ее Национальному конгрессу в ноябре.	Protesters hope to collect a petition of 1.2 million signatures to present to the National Congress in November.
Когда стало ясно, что многие семьи хотели получить правовую помощь, чтобы защититься от выселения, 20 марта в Общественном юридическом центре Ист-Бэй была проведена встреча для жертв жилищного мошенничества.	After it became apparent that many families were seeking legal help to fight the evictions, a meeting was held on March 20 at the East Bay Community Law Center for the victims of the housing scam.
Когда жильцы начали рассказывать, что с ними произошло, большинство участвовавших семей вдруг поняли, что Кэролин Уилсон из OHA украла их гарантийные взносы и сбежала из города.	When the tenants started sharing what had occurred to them, most of the families involved suddenly realized that Carolyn Wilson of the OHA had stolen their security deposits, and skipped out of town.
Жильцы Lockwood Gardens считают, что может быть ещё 40 или больше семей, возможно, столкнуться выселением, так как они узнали, что полиция оклендской жилищной администрации также расследует другие объекты общественного жилья в Окленде, которые могут быть вовлечены в мошенничество с недвижимостью.	Tenants at Lockwood Gardens believe that there may be another 40 families or more to face eviction, since they learned that OHA police are also investigating other public housing properties in Oakland that may be caught up in the housing scam.
Группа отменила выступление на Военном мемориальном стадионе на острове Мауи, на котором должны были быть 9 000 человек, и принесла извинения фанатам.	The band canceled the show at Maui's War Memorial Stadium, which was set to be attended by 9,000 people, and apologized to fans.
Изначально 20 сентября компания HK Management Inc., которая работает с группой, не дала никаких пояснений, а на следующий день объявила, что выступление отменяется по причинам, связанным с логистикой.	The band's management company, HK Management Inc., gave no initial reason when they canceled on September 20, but blamed logistical reasons by the next day.
Знаменитые греческие юристы Сакис Кечагиоглоу и Георг Николакопулос были заключены в афинскую тюрьму Коридаллос, потому что они были признаны виновными во взяточничестве и коррупции.	The famous Greek lawyers, Sakis Kechagioglou and George Nikolakopoulos have been imprisoned in the Athens' jail of Korydallus, as they were found guilty of graft and corruption.
В результате этого в юридическом сообществе Греции разразился большой скандал вследствие разоблачения незаконных действий, совершённых судьями, юристами, солиситорами и адвокатами за прошлые годы.	As a result of this, a big scandal within the Greek legal community has been raised through the exposure of illegal actions that judges, lawyers, solicitors and attorneys have done during the previous years.
Несколькими неделями ранее, после того как журналист Макис Триантафилопулос обнародовал информацию в своем популярном ТВ-шоу Zoungla на канале Alpha TV, член парламента и юрист Петрос Мантувалос сложил полномочия, так как сотрудники его аппарата были вовлечены во взяточничество и коррупцию.	A few weeks ago, after the information published by the journalist Makis Triantafylopoulos in his popular Television show "Zoungla" in Alpha TV, the member of Parliament and lawyer, Petros Mantouvalos was abdicated as members of his office had been involved in illegal graft and corruption.
Кроме того, верховный судья Эвангелос Калусис находится в тюрьме за то, что он признан виновным в коррупции и за извращенное поведение.	Moreover, top judge Evangelos Kalousis is imprisoned as he found guilty of corruption and degenerate behaviour.
Среди населения Ред-Лейк во время похорон Джеффри Уиза и трёх из девяти жертв прошли новости, что еще один студент был задержан в связи со стрельбой в школе 21 марта.	News spread in the Red Lake community today as funerals for Jeff Weise and three of the nine victims were held that another student was arrested in connection with the school shootings of March 21.
Власти почти ничего не заявили официально, за исключением подтверждения сегодняшнего ареста.	Authorities said little officially beyond confirming today's arrest.
Тем не менее, источник, обладающий информацией о расследовании, сообщил газете Star-Tribune в Миннеаполисе, что это был Луи Журден, 16-летний сын Флойда Журдена, председателя племени в Ред-Лейк.	However, a source with knowledge of the investigation told the Minneapolis Star-Tribune that it was Louis Jourdain, 16-year old son of Red Lake Tribal Chairman Floyd Jourdain.
На данный момент неизвестно, какие будут предъявлены обвинения и как сотрудники органов вышли на мальчика, но в федеральном суде началось разбирательство в отношении несовершеннолетнего.	It is not known at this time what charges will be laid or what led authorities to the boy but juvenile proceedings have begun in federal court.
Кристофер Гарсиа, представитель департамента полиции Лос-Анжелоса, сказал, что мужчина подозреваемый в преступлении, находится под следствием скорее по подозрению в незаконном проникновении, чем в вандализме.	Christopher Garcia, a spokesperson of the Los Angeles Police Department, said the suspected male offender is being investigated for trespassing rather than vandalism.
Физически знак не был поврежден; его модифицировали, используя кусок брезента со знаками мира и сердца, чтобы буква "О" стала похожа на маленькую "е".	The sign was not physically damaged; the modification was done using black tarpaulins decorated with signs of peace and heart to alter the "O" to read lowercase "e".
Процесс проходил в Бирмингемском Суде короны и завершился 3 августа.	The trial took place at Birmingham Crown Court and concluded on August 3.
Ведущий, который был арестован на месте происшествия, отрицал нападение и утверждал, что использовал палку для защиты от бутылок, которые в него бросали почти тридцать человек.	The presenter, who was arrested at the scene, denied the attack and claimed he used the pole to protect himself from bottles being thrown at him by up to thirty people.
Блейк так же был обвинён в попытке извратить ход правосудия.	Blake was also convicted of attempting to pervert the course of justice.
Судья сказал Блейку, что это "почти неизбежно" и он будет отправлен в тюрьму.	The judge told Blake it was "almost inevitable" he was going to be sent to jail.
Мужчина предположительно въехал в толпу на трехколесном транспортном средстве, в котором находилась взрывчатка.	The man allegedly drove a three-wheeled vehicle armed with explosives into a crowd.
Мужчина, подозреваемый в совершении взрыва, был арестован после получения травм от взрыва.	The man suspected of detonating the bomb was detained, after sustaining injuries from the blast.
Его имя до сих пор не известно властям, хотя они знают, что он является представителем уйгурской этнической группы.	His name is still unknown to authorities, although they do know he is a member of the Uighur ethnic group.
Ситуация возникла 1 января, когда десятки местных жителей начали жаловаться в почтовое управление Обанадзавы, что не получили свои традиционные регулярно приходившие новогодние открытки.	The issue started on January 1st when dozens of local residents started complaining to the Obanazawa Post Office that they hadn't received their traditional and regular New Year cards.
Вчера почтовое отделение принесло свои извинения гражданам и СМИ, обнаружив, что этот мальчик спрятал более 600 почтовых документов, в том числе 429 новогодние открытки, которые не были доставлены получателям, для которых они предназначались.	Yesterday, the post office released their apology to citizens and the media after discovering that the boy had hidden more than 600 postal documents, including 429 New Year postcards, which weren't delivered to their intended recipients.
"Спасибо тем, кто поддерживал такую осуждённую, как я", — по сообщениям сказала Сирипорн на пресс-конференции.	"Thanks for those who supported a convict like me," Siriporn was quoted as saying at a press conference.
Некоторые могут не соглашаться, но меня это не волнует.	"Some may not agree but I don't care.
Я счастлива, что есть люди, которые готовы меня поддержать.	I am happy that there are people willing to support me.
Она сказала: "Нет никаких разведданных, позволяющих предположить, что в скором времени ожидается нападение".	She said, "There is no intelligence to suggest that an attack is expected imminently.
Однако снижение уровня угрозы до высокого не означает, что угрозы больше нет."	However, the reduction of the threat level to severe does not mean the overall threat has gone away."
Хотя государственные органы не уверены в реальности угрозы, транспортное управление штата Мэриленд закрыло туннель по требованию ФБР.	While authorities are unsure of the credibility of the threat, the Maryland Transportaion Authority made the closure with the urging of the FBI.
Для перекрытия входов в метро были использованы самосвалы, а подмога из 80 полицейских направляла автомобилистов в объезд.	Dump trucks were used to block tube entrances and assistance of 80 police were on hand to direct motorists to detours.
О существенных задержках движения на кольцевой автодороге, дополнительной городской трассе, не сообщалось.	There were no heavy traffic delays reported on the beltway, the city's alternate route.
Дело было возбуждено в Вирджинии, так как там находится главный офис ведущего интернет-провайдера AOL, компании, которая выдвинула обвинения.	The case was prosecuted in Virginia because it is the home to the leading internet service provider AOL, the company who instigated the charges.
Это было первое дело, в котором был вынесен приговор на основании принятого в 2003 году законодательства против массовых рассылок электронных писем пользователям, которые не давали на это согласие, так называемого спама.	This is the first time a conviction has been gained using the legislation enacted in 2003 to curb bulk e-mail, aka spam, from unsolicited distribution into users mailboxes.
Организация "Освобождение животных" и Королевское общество по предотвращению жестокого обращения с животными (RSPCA) снова призывают к обязательной установке камер видеонаблюдения на всех австралийских скотобойнях.	Animal Liberation and the Royal Society for the Prevention of Cruelty to Animals (RSPCA) are again calling for the mandatory installation of CCTV cameras in all Australian abattoirs.
Дэвид О'Шаннесси, главный инспектор RSPCA в Новом Южном Уэльсе, сообщил ABC, что инспекции и наблюдения за скотобойнями в Австралии должны стать обыденностью.	RSPCA New South Wales chief inspector David O'Shannessy told the ABC that surveillance and inspections of abattoirs should be commonplace in Australia.
"Система видеонаблюдения, безусловно, станет четким сигналом для всех людей, работающих с животными, о том, что их благополучие имеет первостепенное значение".	"The CCTV would certainly send a strong signal to those people working with animals that their welfare is of the highest priority."
Карно является знаменитым учителем английского со спорной репутацией. Он преподавал в учебных заведениях "Современное образование" и "Королевская слава" и заявлял, что на пике карьеры у него было 9000 учащихся.	Karno is a well-known but controversial English tutor who taught under Modern Education and King's Glory who claimed to have 9,000 students at the peak of his career.
В своих записках он использовал слова, которые некоторые родители сочли грубыми, и, как сообщается, он использовал нецензурную лексику на занятиях.	In his notes he used words which some parents considered coarse, and he reportedly used profanity in class.
Компания Modern Education обвинила его в том, что он печатал большие рекламные объявления на автобусах без соответствующего разрешения, и за то, что он лгал, утверждая, что является их старшим преподавателем английского языка.	Modern Education accused him of printing large advertisements on buses without authorisation and lying by saying that he was the chief English tutor.
Он также ранее был обвинён в нарушении авторских прав, но ему не было предъявлено никаких обвинений.	He has also been accused previously of copyright infringement, but was not charged.
Бывший студент сообщил, что он "использовал сленг на занятиях, давал советы о романтических знакомствах в конспектах и был для студентов как друг".	A former student said that he 'used slang in class, taught dating skills in notes, and was just like the students' friend.'
Историки критикуют прошлую политику ФБР за то, что выделяла большую часть ресурсов на дела, которые легко раскрываются, особенно на дела об угоне автомобилей, с целью повышения уровня успешности работы агентства.	Historians have criticized past FBI policies for focusing resources on cases which are easy to solve, especially stolen car cases, with the intent of boosting the agency's success rate.
Конгресс начал финансировать инициативу по борьбе с развратом в 2005 налоговом году и определил, что ФБР должно выделить 10 агентов на борьбу со взрослой порнографией.	Congress began funding the obscenity initiative in fiscal 2005 and specified that the FBI must devote 10 agents to adult pornography.
Обвинение в убийстве при отягчающих обстоятельствах будет предъявлено врачу, которая работала в Детской больнице Питтсбурга, Пенсильвания, после того как в среду ее мать нашли мертвой в багажнике ее автомобиля, сообщают власти Огайо.	A doctor who worked at Children's Hospital of Pittsburgh, Pennsylvania will be charged with aggravated murder after her mother was found dead in the trunk of her car Wednesday, authorities in Ohio say.
Доктора Малар Баласубраманиан, 29 лет, нашли в Блю-Эше (штат Огайо), пригороде примерно в 15 милях к северу от Цинциннати. Он лежал на земле рядом с дорогой в футболке и нижнем белье и, по-видимому, в состоянии сильного наркотического опьянения.	Dr. Malar Balasubramanian, 29, was found in Blue Ash, Ohio, a suburb approximately 15 miles north of Cincinnati lying on the ground beside the road in a T-shirt and underwear in an apparently heavily medicated state.
Она отправила офицеров в свой чёрный Олдсмобиль Интрига, который находился в 500 футах.	She directed officers to her black Oldsmobile Intrigue which was 500 feet away.
Там они нашли тело 53-летнего Сароджи Баласубраманиана, покрытое окровавленными одеялами.	There, they found the body of Saroja Balasubramanian, 53, covered with blood-stained blankets.
Полиция сказала, что тело, скорее всего, находилось там около дня.	Police said that the body appeared to have been there for about a day.
Когда драка прекратилась, после того как раненые были доставлены в больницу, еще около 40 заключенных остались во дворе и отказались возвращаться в свои камеры.	When the fighting ceased after the wounded were transported to the hospital, about 40 of the other remaining inmates stayed in the yard and refused to return to their cells.
Переговорщики попытались исправить ситуацию, но требования заключённых не ясны.	Negotiators tried to rectify the situation, but the prisoners' demands are not clear.
Между 10:00 и 11:00 вечера по горному времени заключенные устроили пожар во дворе.	Between 10:00-11:00 pm MDT, a fire was started by the inmates in the yard.
Вскоре надзиратели в защитном снаряжении прошли во двор и загнали заключенных в угол, применив слезоточивый газ.	Soon, officers equipped with riot gear entered the yard and cornered the inmates with tear gas.
В результате бригады пожарных потушили пожар к 23:35.	Fire rescue crews eventually doused the fire by 11:35 pm.
Согласно сообщениям, массовое мародерство продолжалось всю ночь, поскольку на улицах Бишкека не было сотрудников органов охраны правопорядка.	Widespread looting reportedly continued overnight, as law enforcement officers were not present on Bishkek's streets.
Бишкек был описан одним обозревателем как погружающийся в состояние анархии, поскольку группы людей бегали по улицам и грабили магазины с потребительскими товарами.	Bishkek was described as sinking into a state of "anarchy" by one observer, as gangs of people roamed the streets and plundered stores of consumer goods.
Некоторая часть жителей Бишкека обвинила митингующих с юга в беззаконии.	Several Bishkek residents blamed protesters from the south for the lawlessness.
Ранее китайское новостное агентство "Синьхуа" сообщило, что самолет был угнан.	Earlier the Chinese news agency Xinhua reported a plane to be hijacked.
Позже сообщалось, что на самолет поступила угроза взрыва бомбы и он был развернут обратно в Афганистан, приземлившись в Кандагаре.	Later reports then stated the plane received a bomb threat and was diverted back to Afghanistan, landing in Kandahar.
В ранних сообщениях говорится, что самолёт возвратился в Афганистан после того, как ему было отказано в экстренной посадке в Урумчи.	The early reports say the plane was diverted back to Afghanistan after being denied an emergency landing in Ürümqi.
Одна из бомб взорвалась возле офиса генерал-губернатора.	One bomb exploded outside the governor general's office.
Еще три бомбы взорвались возле правительственных зданий в течение двух часов.	Three more bombs exploded near government buildings in a period of two hours.
По некоторым сообщениям, официальное количество жертв достигает восьми человек, и официальные сводки подтверждают, что до 30 человек были ранены; но окончательные цифры еще неизвестны.	Some reports put the official death toll at eight, and official reports confirm that up to 30 were injured; but final numbers are not yet known.
В образцах мочи животных, умерших после поедания загрязненной еды для животных, были обнаружены как циануровая кислота, так и меламин.	Both cyanuric acid and melamine were found in urine samples from pets that died after consuming contaminated pet food.
Исследователи университета сообщили, что эти два соединения вступают друг с другом в реакцию, образуя кристаллы, которые могут блокировать работу почек.	The two compounds react with one another to form crystals that may block kidney function, researchers at the university said.
Во время наблюдений исследователи обнаружили кристаллические образования, возникающие в кошачьей моче при добавлении циануровой кислоты и меламина.	The researchers observed crystals formed in cat urine by the addition of melamine and cyanuric acid.
Во время сравнения при помощи инфракрасной Фурье-спектроскопии выяснилось, что состав этих кристаллов соответствует кристаллам, найденным в моче поражённых домашних животных.	The composition of these crystals matches those found in the urine of affected pets when compared by infrared spectroscopy (FTIR).
Погибшими были Николас Алден, 25 лет, и Захари Каддебэк, 21 год. Каддебэк был водителем.	The fatalities were Nicholas Alden, 25, and Zachary Cuddeback, 21. Cuddeback had been the driver.
Эдгар Вегилла получил ранения руки и челюсти, тогда как Кристоффер Шнайдер нуждался в реконструктивной хирургии на лице.	Edgar Veguilla received arm and jaw wounds while Kristoffer Schneider was left requiring reconstructive surgery for his face.
Орудие Уки вышло из строя, когда было нацелено в голову пятому мужчине. Шнайдер ощущает непрекращающуюся боль, он слеп на один глаз, у него отсутствует часть черепа, а лицо реконструировано с помощью титана.	Uka's weapon failed whilst pointed at a fifth man's head. Schneider has ongoing pain, blindness in one eye, a missing section of skull and a face rebuilt from titanium.
Шнейдер дал показания через видеосвязь с базы ВВС США у себя на родине.	Schneider testified via videolink from a USAF base in his homeland.
Полиция штата Мадхья-Прадеш вернула украденные ноутбук и мобильный телефон.	The Madhya Pradesh Police recovered the stolen laptop and mobile phone.
Заместитель генерального инспектора Д. К. Арья заявил: "Мы арестовали пять человек, изнасиловавших швейцарку, и вернули ее мобильный телефон и ноутбук".	Deputy Inspector General D K Arya said, "We have arrested five persons who raped the Swiss woman and recovered her mobile and laptop".
Обвиняемые имеют имена Баба Канджар, Бхута Канджар, Рампро Канджар и Вишну Канджар.	The accused are named as Baba Kanjar, Bhutha Kanjar, Rampro Kanjar, Gaza Kanjar and Vishnu Kanjar.
Начальник полиции Чандра Шехар Соланки заявил, что обвиняемые были представлены перед судьями с закрытыми лицами.	Police superintendent Chandra Shekhar Solanki said the accused appeared in court with covered faces.
Впоследствии Эдинбургский шерифский суд предъявил Адекое обвинение в убийстве ее сына.	Adekoya has since been in Edinburgh Sheriff Court charged with murdering her son.
Она находится под стражей в ожидании вынесения ей обвинения и проведения судебного разбирательства, однако любые свидетельские показания могут быть искажены, поскольку её популярность широко использовалась СМИ.	She is in custody pending indictment and trial, but any eyewitness evidence may be tainted because her image has been widely published.
Это является обычной практикой в других частях Великобритании, но шотландское правосудие работает по-другому, и суды сочли публикацию фотографий как потенциально наносящую ущерб.	This is common practice elsewhere in the UK but Scottish justice works differently and courts have viewed publication of photos as potentially prejudicial.
Профессор Памела Фергюсон из Университета Данди отмечает, что "журналисты, похоже, и вправду ходят по опасной грани, публикуя фотографии и прочие данные о подозреваемых".	Professor Pamela Ferguson of the University of Dundee notes "journalists do seem to be walking a dangerous line if publishing photos etc of suspects."
Королевская прокуратура, которая в целом отвечает за судебное преследование, сообщила журналистам, что никаких дальнейших комментариев не будет сделано, по крайней мере, до вынесения обвинительного приговора .	Crown Office, which is in overall charge of prosecutions, has indicated to journalists that no further comment will be made at least until indictment.
Бывший филиппинский полицейский угнал туристический автобус в Маниле, столице Филиппин, и взял в заложники гонконгских туристов.	A former Filipino policeman has kept Hong Kong tourists hostage by hijacking their bus in Manila, the capital of the Philippines.
Роландо Мендоса выстреливал из своей винтовки М16 в туристов.	Rolando Mendoza fired his M16 rifle at the tourists.
Несколько заложников были спасены, а как минимум шестеро были признаны погибшими на данный момент.	Several hostages have been rescued and least six have been confirmed dead so far.
Шестеро заложников, включая детей и пожилых людей, освободили раньше, как и филиппинских фотографов.	Six hostages, including the children and elderly, were released early, as were the Filipino photographers.
Позже фотографы заняли место пожилой женщины, так как она отлучилась в туалет. Мендосу застрелили.	The photographers later took the place of an aged lady as she needed the lavatory. Mendoza was gunned down.
