Автобус следует в Six Flags St. Louis в Миссури, где музыканты должны будут сыграть перед огромной аудиторией.	The bus was headed to Six Flags St. Louis in Missouri for the band to play to a sold-out crowd.
В 01:15 в субботу, по словам очевидцев, автобус проезжал на зелёный свет, когда автомобиль сделал поворот перед ним.	At 1:15 a.m. Saturday, according to witnesses, the bus was going through a green light when the car made a turn in front of it.
В ночь на 9 августа глаз Моракота находился примерно в семидесяти километрах от китайской провинции Фуцзянь.	As of the night of August 9, the eye of Morakot was about seventy kilometres away from the Chinese province of Fujian.
Согласно прогнозам, тайфун движется в сторону Китая со скоростью одиннадцать километров в час.	The typhoon is estimated to be moving toward China at eleven kph.
Вчера Twin Otter уже пытался зайти на посадку в Кокоде как рейс CG4684 компании Airlines PNG, но не смог завершить попытку.	The Twin Otter had been trying to land at Kokoda yesterday as Airlines PNG Flight CG4684, but had aborted once already.
Примерно за 10 минут до планируемой посадки со второго захода он исчез.	About ten minutes before it was due to land from its second approach it disapeared.
Сегодня было установлено место крушения, но к нему настолько трудно добраться, что двое полицейских были опущены в джунгли, чтобы они дошли до места происшествия и нашли выживших.	The crash site was located today and is so inaccessable that two policemen were dropped into the jungle in order to hike to the scene and seek survivors.
Эти поиски затруднялись из-за той же плохой погоды, которая помешала завершить посадку.	The search had been hampered by the same bad weather that had caused the aborted landing.
Сообщается, что взрыв в квартире на улице Макбет произошел из-за утечки газа.	According to reports, an apartment on Macbeth Street exploded due to a gas leak.
Представитель газовой компании прибыл на место происшествия после звонка соседа об утечке газа.	An official with the gas company was reporting to the scene after a neighbor called about a gas leak.
Когда прибыл официальный представитель, в квартире произошел взрыв.	When the official arrived, the apartment exploded.
О серьезных ранениях не сообщалось, но по крайней мере пятерым людям с симптомами шока, находившимся на месте происшествия в момент взрыва, понадобилась медицинская помощь.	No major injuries were reported, but at least five people on scene at the time of the explosion were treated for symptoms of shock.
В квартире никого не было.	No one was inside the apartment.
Тогда из этого района было эвакуировано почти 100 жителей.	At the time, nearly 100 residents were evacuated from the area.
На вечеринке по случаю празднования первой годовщины пары, свадьба которой состоялась в прошлом году, присутствовало не меньше 100 человек.	At least 100 people had attended the party, in order to celebrate the first anniversary of a couple whose wedding was held last year.
Власти сообщили, что официальное мероприятие в честь годовщины было перенесено на более позднюю дату.	A formal anniversary event was scheduled for a later date, officials said.
Пара поженилась в Техасе год назад и приехала в Буффало, чтобы отпраздновать это событие с друзьями и родственниками.	The couple had married in Texas one year ago and came to Buffalo to celebrate with friends and relatives.
30-ти летний муж, который родился в Буффало, был одним из четырёх людей, убитых при стрельбе, но его жена не пострадала.	The 30-year-old husband, who was born in Buffalo, was one of the four killed in the shooting, but his wife was not hurt.
Тропический шторм "Даниэлла", четвёртый шторм с названием в сезоне ураганов в Атлантике 2010 года, образовался в восточной части Атлантического океана.	Tropical Storm Danielle, fourth named storm of the 2010 Atlantic hurricane season, has formed in the eastern Atlantic Ocean.
Шторм, находящийся примерно в 3000 милях от Майами в штате Флорида, имеет максимальную устойчивую скорость ветра 40 миль/ч (64 км/ч).	The storm, located approximately 3,000 miles from Miami, Florida, has maximum sustained winds of 40 mph (64 kph).
Учёные из Национального центра ураганов предсказывают, что к среде "Даниэль" усилится до урагана.	Scientists at the National Hurricane Center predict that Danielle will strengthen to a hurricane by Wednesday.
Шторм пока далеко от берега, поэтому все еще тяжело оценить его возможное влияние на страны Карибского бассейна и США.	As the storm is far from landfall, it remains difficult to assess potential impact to the United States or Caribbean.
Питер Ленц, 13-летний мотогонщик, погиб в результате автокатастрофы на "Индианаполис Мотор Спидвей".	Peter Lenz, a 13-year-old motorcycle racer, has died after being involved in a crash at the Indianapolis Motor Speedway.
Во время разминочного круга Ленц упал с мотоцикла, после чего его сбил коллега по гонке Ксавьер Заят.	While on his warm-up lap, Lenz fell off his bike, and was then struck by fellow racer Xavier Zayat.
Дежурный медицинский персонал немедленно оказал ему первую помощь и доставил его в местную больницу, где он впоследствии скончался.	He was immediately attended to by the on-track medical staff and transported to a local hospital where he later died.
Заят не пострадал в аварии.	Zayat was unhurt in the accident.
Согласно последней сводке, данные наблюдений за уровнем моря указывали на приближение цунами. Явная сейсмическая активность была зарегистрирована возле Паго-Паго и Ниуэ.	According to the latest bulletin, sea level readings indicated a tsunami was generated. There was some definite tsunami activity recorded near Pago Pago and Niue.
Из Тонга не поступило сообщений о серьезных разрушениях или о пострадавших, но произошло временное отключение электроснабжения, что, по имеющимся данным, не позволило властям Тонга получить предупреждение о цунами, посланное Тихоокеанским центром предупреждения о цунами (PTWC).	No major damage or injuries have been reported in Tonga, but power was temporarily lost, which reportedly prevented Tongan authorities from receiving the tsunami warning issued by the PTWC.
Четырнадцать школ на Гавайях, расположенных на побережье или вблизи него, были закрыты в среду, несмотря на отмену предупреждений.	Fourteen schools in Hawaii located on or near coastlines were closed all of Wednesday despite the warnings being lifted.
Авиакатастрофы — обычное явление для Ирана, где используется стареющий авиапарк, который плохо обслуживается как для гражданских, так и для военных операций.	Air accidents are common in Iran, which has an aging fleet that is poorly maintained both for civil and military operations.
Международные санкции привели к невозможности покупки новых воздушных судов.	International sanctions have meant that new aircraft cannot be purchased.
Ранее на этой неделе в результате крушения полицейского самолёта погибло три человека и было ранено еще три.	Earlier this week, a police helicopter crash killed three people and wounded three more.
В прошлом году в Иране произошла худшая за годы авиакатастрофа, когда разбился следовавший в Армению авиалайнер, в результате чего погибли 168 человек, находившиеся на борту.	Last month Iran saw its worst air disaster in years when an airliner heading to Armenia crashed, killing the 168 on board.
В том же месяце другой авиалайнер выкатился за пределы взлетной полосы в Мешхеде и врезался в стену, погибли семнадцать человек.	The same month saw another airliner overrun a runway at Mashhad and strike a wall, killing seventeen.
В 07:19 утра по местному времени (21:19 по Гринвичу в пятницу) произошло землетрясение в Мариане.	The eathquake struck Mariana at 07:19 a.m. local time (09:19 p.m. GMT Friday).
Управление по чрезвычайным ситуациям Северных Марианских островов заявило, что в стране не было сообщений о причинённом ущербе.	The Northern Marianas emergency management office said that there were no damages reported in the nation.
Также Тихоокеанский центр предупреждения цунами заявил, что никаких признаков цунами не было.	Also the Pacific Tsunami Warning Center said that there was no Tsunami indication.
Как передает Синьхуа, в среду государственные следователи обнаружили два бортовых самописца или, по-другому, "черных ящика".	Xinhua reported that government investigators recovered two 'black box' flight recorders on Wednesday.
