Задолго до The Daily Show и The Colbert Report, когда еще в 1988 году Хек и Джонсон были студентами Висконсинского университета в Мадисоне, они придумали идею для печатного издания, которое бы пародировало выпуски и репортажи новостей.	Long before The Daily Show and The Colbert Report, Heck and Johnson envisioned a publication that would parody the news—and news reporting—when they were students at UW in 1988.
С момента своего создания The Onion стала настоящей империей пародий на новости, имея печатное издание, сайт, который в октябре посетили 5 000 000 пользователей, службу персональных объявлений, круглосуточную новостную сеть, подкасты и недавно вышедший атлас мира под названием "Наш глупый мир".	Since its inception, The Onion has become a veritable news parody empire, with a print edition, a website that drew 5,000,000 unique visitors in the month of October, personal ads, a 24 hour news network, podcasts, and a recently launched world atlas called Our Dumb World.
Эл Гор и генерал Томми Фрэнкс непринуждённо составили список своих любимых заголовков (у Гора это был заголовок, в котором The Onion сообщил, что у них с Типпер был лучший секс в их жизни после его поражения на выборах, по решению Коллегии выборщиков, в 2000 году).	Al Gore and General Tommy Franks casually rattle off their favorite headlines (Gore's was when The Onion reported he and Tipper were having the best sex of their lives after his 2000 Electoral College defeat).
Многие из их авторов позднее оказали огромное влияние на пародийные новостные передачи Джона Стьюарта и Стивена Кольбера."	Many of their writers have gone on to wield great influence on Jon Stewart and Stephen Colbert's news parody shows.
Это культурное событие также является частью кампании мэрии Бухареста по превращению столицы Румынии в яркий творческий мегаполис.	The artistic event is also part of a campaign by the Bucharest City Hall that seeks to relaunch the image of the Romanian capital as a creative and colourful metropolis.
Этот город станет первым городом юго-восточной Европы, в котором пройдёт CowParade — крупнейшее в мире мероприятие в области общественного искусства, которое будет проходить с июня по август этого года.	The city will be the first in southeastern Europe to host CowParade, the world's largest public art event, between June and August this year.
Этот фильм с участием Райана Гослинга и Эммы Стоун получил номинации во всех главных категориях.	The movie, featuring Ryan Gosling and Emma Stone, received nominations in all major categories.
Гослинг и Стоун получили номинации на лучшего актера и актрису соответственно.	Gosling and Stone received nominations for Best Actor and Actress respectively.
Среди других номинаций: "Лучшая картина", "Режиссёр", "Операторская работа", "Дизайн костюмов", "Монтаж фильма", "Оригинальная музыка", "Художник-постановщик", "Звуковой монтаж", "Звук" и "Оригинальный сценарий".	The other nominations include Best Picture, Director, Cinematography, Costume Design, Film-editing, Original Score, Production Design, Sound Editing, Sound Mixing and Original Screenplay.
Две песни из фильма — Audition (The Fools Who Dream) и City of Stars, попали в номинацию лучшая авторская песня. Студия Lionsgate попала в 26 номинаций — больше, чем любая другая студия.	Two songs from the movie, Audition (The Fools Who Dream) and City of Stars, received nominations for best original song. Lionsgate studio received 26 nominations — more than any other studio.
Хотя Уинфри была готова расплакаться во время прощания, она дала понять своим поклонникам, что вернется.	Although Winfrey was tearful in her farewell, she made it clear to her fans she will be back.
"Это не станет прощанием. Это закрытие одной главы и открытие новой."	"This is not going to be goodbye. This is the closing of one chapter and the opening of a new one."
Сайт станции описывает шоу как "традиционный радиотеатр с новым и возмутительно задротным видением!".	The station's web site describes the show as "old school radio theater with a new and outrageous geeky spin!"
В начальный период своего существования это шоу транслировалось только на сайте давно существующего онлайн-радио TogiNet Radio, посвященного радиобеседам.	In its early days, the show was featured solely at the long-running internet radio site TogiNet Radio, a site focused on talk radio.
В конце 2015 года TogiNet создала AstroNet Radio в качестве дочерней радиостанции.	In late 2015, TogiNet established AstroNet Radio as a subsidiary station.
Первоначально шоу озвучивали актёры-любители из Восточного Техаса.	The show originally featured amateur voice actors, local to East Texas.
История, рассказанная во французской опере Камилем Сен-Сансом, повествует о художнике, "жизнью которого управляет любовь к наркотикам и к Японии".	The story presented in the French opera, by Camille Saint-Saens, is of an artist "whose life is dictated by a love for drugs and Japan."
В результате актёры курят косяки с марихуаной на сцене, и сам театр поощряет публику присоединиться.	As a result, the performers smoke cannabis joints on stage, and the theatre itself is encouraging the audience to join in.
Фотограф был доставлен в медицинский центр имени Рональда Рейгана при  Калифорнийском университете в Лос-Анджелесе, где он впоследствии скончался.	The photographer was transported to Ronald Reagan UCLA Medical Center, where he subsequently died.
По сообщениям ему было от 20-ти до 30-ти лет. В заявление Бибер сказал: "Хотя я и не присутствовал при трагическом инциденте и не был вовлечён в него напрямую, мои мысли и молитвы с семьёй жертвы".	He was reportedly aged in his 20s. In a statement, Bieber said "[w]hile I was not present nor directly involved with this tragic accident, my thoughts and prayers are with the family of the victim."
Развлекательно-новостной сайт TMZ полагает, что фотограф остановил свой автомобиль на противоположной стороне бульвара Сепульведа и попытался сделать снимки остановки полицейскими, перед тем как перейти дорогу и продолжить. Полицейский Калифорнийского дорожного патруля, остановивший движение, дважды был вынужден приказать ему перейти обратно.	Entertainment news website TMZ understands the photographer stopped his vehicle on the other side of Sepulveda Boulevard and attempted to take pictures of the police stop before crossing the road and continuing, prompting the California Highway Patrol police officer conducting the traffic stop to order him back across, twice.
По сообщениям полиции, водителю автомобиля, сбившего фотографа, скорее всего, не будет предъявлено уголовное обвинение.	According to police, the driver of the vehicle that hit the photographer is unlikely to face criminal charges.
До "Симпсонов" Саймон работал на различных должностях над несколькими передачами.	Before The Simpsons Simon had worked on several shows in various positions.
В 1980-х годах он работал в таких передачах, как "Такси", "Веселая компания" и "Шоу Трейси Ульман".	During the 1980s he worked on shows such as Taxi, Cheers, and The Tracy Ullman Show.
В 1989 году вместе с Бруксом и Гронингом он помогал создать "Симпсонов" и был ответственным за набор первой команды сценаристов этого сериала.	In 1989 he helped create The Simpsons with Brooks and Groening, and was responsible for hiring the show's first writing team.
Несмотря на уход из шоу в 1993 году, он остался исполнительным продюсером и каждый сезон по-прежнему получал гонорары в размере десятков миллионов долларов.	Despite leaving the show in 1993 he kept the title of executive producer, and continued to receive tens of millions of dollars every season in royalties.
Президент Nintendo Сатору Ивата (Satoru Iwata) представил дизайн новой игровой приставки Nintendo Revolution на главной презентации "Токийской выставки игр" в четверг.	At Thursday's keynote presentation of the Tokyo Game Show, Nintendo president Satoru Iwata unveiled the controller design for the company's new Nintendo Revolution console.
В контроллере, который выглядит как телевизионный пульт, используются два датчика, находящиеся рядом с телевизором пользователя, с помощью которых вычисляется его положение в трёхмерном пространстве.	Resembling a television remote, the controller uses two sensors placed near the user's television to triangulate its position in three-dimensional space.
Посредством движения устройства в воздухе игроки смогут управлять действиями и движениями в видеоиграх.	This will allow players to control actions and movements in video games by moving the device through the air.
"Она очень симпатичная и весьма хорошо поёт", — сказал он, ссылаясь на стенограмму пресс-конференции.	"She’s very cute and sings quite well, too," he said according to a transcript of the news conference.
"Я был совершенно искренне тронут каждый раз, когда мы это репетировали."	"I was moved every time we did a rehearsal on this, from the bottom of my heart."
