Красный прилив вызван более высокой, чем обычно, концентрацией Karenia brevis, одноклеточного морского организма, встречающегося в природе.	Red tide is caused by a higher than normal concentration of Karenia brevis, a naturally-occurring single-celled marine organism.
Факторы природы могут воздействовать таким образом, что создаются идеальные условия, позволяющие этим водорослям резко увеличивать свою численность.	Natural factors can intersect to produce ideal conditions, allowing this algae to increase in number dramatically.
Эти водоросли вырабатывают нейротоксин, который может отключить работу нервной системы как у людей, так и у рыб.	The algae produces a neurotoxin that can disable nerves in both humans and fish.
Обычно рыбы погибают из-за высокой концентрации токсических веществ в воде.	Fish often die because of the high concentrations of the toxin in the waters.
Люди могут пострадать, вдыхая загрязненную воду, попавшую в воздух с ветром и волнами.	Humans can be affected by breathing affected water taken into the air by wind and waves.
На своём пике тропический циклон Гону, название которого на языке Мальдивских островов означает "сумка из пальмовых листьев", достигал силы ветра в 240 километров в час (149 миль в час).	At its peak, Tropical Cyclone Gonu, named for a bag of palm leaves in the language of the Maldives, reached sustained winds of 240 kilometers an hour (149 miles per hour) .
К началу сегодняшнего дня скорость ветра достигала около 83 км/ч, и ожидалось, что она будет продолжать снижаться.	By early today, winds were around 83 km/h, and it was expect to keep weakening.
На борту "Луно" находилось 120–160 кубических метров топлива, когда он сломался и сильный ветер c волнами столкнули его с волнорезом.	The Luno had 120–160 cubic metres of fuel aboard when it broke down and high winds and waves pushed it into the breakwater.
Вертолёты спасли всех двенадцать членов экипажа, и единственной травмой был сломанный нос.	Helicopters rescued the twelve crewmembers and the only injury was a broken nose.
Корабль стометровой длины находился в пути, чтобы забрать свой обычный груз с удобрениями, и в начале представители власти опасались, что он может разлить груз.	The 100-metre ship was en route to pick up its usual fertiliser cargo and initially officials feared the vessel could spill a load.
"Мы будем предпринимать усилия с целью значительного сокращения выбросов углекислого газа на единицу ВВП к 2020 году по сравнению с уровнем 2005 года", — сказал Ху.	"We will endeavour to cut carbon dioxide emissions per unit of GDP by a notable margin by 2020 from the 2005 level," Hu said.
Он не назвал цифру для сокращений бюджетов, сказав, что они будут сделаны исходя из производительности экономики Китая.	He did not set a figure for the cuts, saying they will be made based on China's economic output.
Ху призывал развивающиеся страны "избегать старой схемы, в которой сначала загрязняют, а потом очищают".	Hu encouraged developing countries "to avoid the old path of polluting first and cleaning up later."
Он добавил, что "их, однако, не следует просить брать на себя обязательства, которые выходят за рамки их стадии разработки, ответственности и возможностей".	He added that "they should not, however, be asked to take on obligations that go beyond their development stage, responsibility and capabilities."
Умеренное землетрясение произошло в понедельник в западной части штата Монтана в 22:08.	A moderate earthquake shook western Montana at 10:08 p.m. on Monday.
Геологическая служба США (USGS) и ее Национальная информационная служба по землетрясениям не получали никаких срочных сообщений об ущербе.	No immediate reports of damage have been received by the United States Geological Survey (USGS) and its National Earthquake Information Center.
Эпицентр землетрясения был примерно в 20 км (15 милях) северо-восточнее Диллона и около 65 км (40 миль) южнее Бьютта.	The earthquake was centered about 20 km (15 miles) north-northeast of Dillon, and about 65 km (40 miles) south of Butte.
За пять минут до начала салюта ветер начал усиливаться, минутой позже ветер достиг скорости 70 километров в час... Затем начался дождь, такой сильный и крупный, будто на тебя падают иголки, потом с неба посыпался град, люди в панике кричали и сталкивались друг с другом.	Five minutes into the display a wind starts rolling in, about a minute later, the wind is reaching 70km/h... then the rain comes, but so hard and so large that it slaps your skin like a needle, then hail fell from the sky, people panicking and screaming and running over each other.
Я потерял сестру и ее друга, и на моем пути было двое инвалидов в инвалидных колясках, люди просто прыгали через них и толкали", — рассказывал Арман Версаче.	I lost my sister and her friend, and on my way there were two disabled people in wheelchairs, people just jumping over and pushing them," Armand Versace said.
NHK также сообщила, что АЭС Касивазаки Карива, расположенная в префектуре Ниигата, работала в стандартном режиме.	NHK also reported that the Kashiwazaki Kariwa nuclear power plant in Niigata prefecture was operating normally.
Hokuriku Electric Power Co. сообщила об отсутствии каких-либо последствий землетрясения, а также о том, что реакторы № 1 и № 2 на её атомной электростанции "Сика" были остановлены.	Hokuriku Electric Power Co. reported no effects from the earthquake and that the Number 1 and 2 reactors at its Shika nuclear power plant were shut down.
Сообщается, что около 9400 домов в регионе остались без воды и около 100 без электричества.	It is reported that some 9400 homes in the region are without water and approximately 100 without electricity.
Повреждены некоторые дороги, в пострадавших районах прервано железнодорожное сообщение и аэропорт Ното в префектуре Исикава по-прежнему закрыт.	Some roads have been damaged, railway service interrupted in the affected areas, and the Noto Airport in Ishikawa prefecture remains closed.
