Во время дневной жары путешественники могут увидеть миражи, при которых создается иллюзия воды (или других вещей).	In the heat of the day, travelers can experience mirages that give the illusion of water (or other things).
Они могут быть опасными если путешественник  пойдёт за миражом, теряя ценную энергию и оставшуюся воду.	These can be dangerous if the traveler pursue the mirage, wasting precious energy and remaining water.
По ночам даже самые жаркие пустыни могут стать экстремально холодными. При отсутствии тёплой одежды гипотермия представляет реальный риск.	Even the hottest of deserts can become extremely cold at night. Hypothermia is a real risk without warm clothing.
Если вы решите путешествовать по тропическому лесу – остерегайтесь комаров, особенно летом.	In summer, especially, you'll need to watch out for mosquitoes if you decide to hike through the rainforest.
Даже если вы едете через субтропические джунгли на машине, несколько секунд с открытой дверью, пока вы садитесь в машину, достаточно для того, чтобы москиты проникли в автомобиль вместе с вами.	Even if you're driving through the subtropical rainforest, a few seconds with the doors open while you get inside the vehicle is enough time for mosquitoes to get in the vehicle with you.
Птичий грипп, или более формально классическая чума птиц, может инфицировать и птиц и млекопитающих.	Bird flu, or more formally avian influenza, can infect both birds and mammals.
Есть сведения меньше, чем о тысяче случаев среди людей, но некоторые из них были смертельными.	Fewer than a thousand cases have ever been reported in humans, but some of them have been fatal.
В большинстве случаев пострадали люди, работающие с домашней птицей, но и наблюдатели за птицами также подвергаются риску.	Most have involved people who work with poultry, but there is also some risk to birdwatchers.
Для Норвегии характерно, когда отвесные фьорды и долины внезапно сменяются высокими, практически ровными нагорьями.	Typical for Norway are steep fjords and valleys that suddenly give way to a high, more or less even plateau.
Эти плато часто упоминаются как vidde, что означает широкое открытое место без деревьев, бескрайний простор.	These plateaus are often referred to as "vidde" meaning a wide, open treeless space, a boundless expanse.
В Ругаланне и Агдере их обычно называют "hei", что означает безлесую пустошь, часто покрытую вереском.	In Rogaland and Agder they are usually called "hei" meaning a treeless moorland often covered in heather.
Ледники не имеют постоянной формы, так как стекают по склонам. Это приводит к трещинам и расселинам, которые могут быть спрятаны под снежными мостами.	The glaciers are not stable, but flow down the mountain. This will cause cracks, crevasses, which may be obscured by snow bridges.
Стены и своды ледяных пещер могут обрушиться, и трещины могут быть перекрыты.	The walls and roofs of ice caves can collapse and cracks can get closed.
По краям ледников откалываются огромные глыбы, которые падают вниз и могут отскакивать или катиться дальше от края.	At the edge of glaciers huge blocks break loose, fall down and perhaps jump or roll farther from the edge.
Пик туристического сезона в горных деревушках обычно приходится на индийское лето.	The tourist season for the hill stations generally peaks during the Indian summer.
Впрочем, зимой это другая красота и шарм, с горными деревушками, где выпадает много снега и доступны такие занятия, как катание на горные лыжах и сноуборде.	However, they have a different kind of beauty and charm during winter, with many hill stations receiving healthy amounts of snow and offering activities such as skiing and snowboarding.
Древние обсерватории, как правило, сегодня считаются устаревшими и служат музеями или образовательными учреждениями.	Pre-modern observatories are usually obsolete today, and remain as museums, or sites of education.
Поскольку световое загрязнение в период их расцвета не было такой проблемой, как сегодня, они обычно расположены в городах или в кампусах, до которых легче добраться, чем до тех, которые построены в наше время.	As light pollution in their heyday was not the kind of problem it is today, they are usually located in cities or at campuses, easier to reach than those built in modern times.
Большинство современных исследовательских телескопов — это огромные сооружения в удаленных местах с благоприятными атмосферными условиями.	Most modern research telescopes are enormous facilities in remote areas with favorable atmospheric conditions.
Созерцание цветения сакуры, называемое "ханами", вошло в японскую культуру еще в VIII веке.	Cherry blossom viewing, known as hanami, has been a part of Japanese culture since the 8th century.
Эта идея пришла из Китая, где излюбленным цветком был цвет сливы.	The concept came from China where plum blossoms were the flower of choice.
В Японии первые празднования цветения сакуры устраивались императором только для себя и других членов аристократии при императорском дворе.	In Japan, the first cherry blossom parties were hosted by the emperor only for himself and other members of the aristocracy around the Imperial Court.
Растения выглядят лучше всего в своей естественной среде обитания, поэтому не поддавайтесь искушению взять хотя бы один экземпляр.	Plants look their best when in a natural environment, so resist the temptation to remove even "just one" specimen.
При посещении официально организованного сада сбор "образцов" также приведёт к тому, что вас выгонят без всяких разговоров.	If visiting a formally arranged garden, collecting "specimens" is also going to get you ejected, without discussion.
Сингапур в целом очень безопасное место, где легко ориентироваться, и практически всё можно купить после прибытия.	Singapore is generally an extremely safe place to be and very easy to navigate, and you can buy almost anything after arriving.
Но, оказавшись в "глубоких тропиках" лишь в нескольких градусах к северу от экватора, вам придется справляться как с жарой (постоянно), так и с сильным солнцем (при безоблачном небе, реже).	But being placed in the "high tropics" just a few degrees north of equator you will need to deal with both heat (always) and strong sun (when the sky is clear, more rarely).
Также есть несколько автобусов, идущих на север в Хеброн — легендарное место погребения библейских патриархов Авраама, Исаака и Иакова, а также их жен.	There are also a few buses going north to Hebron, the traditional burial place of the Biblical patriarchs Abraham, Isaac, Jacob, and their wives.
Удостоверьтесь, что автобус, в который Вы собираетесь сесть, направляется в Хеврон, а не только в близлежащее еврейское поселение  Кирьят-Арба.	Check that the bus you are thinking of taking goes into Hebron and not just to the nearby Jewish settlement of Kiryat Arba.
Внутренние водные пути могут стать хорошей темой для проведения какого-либо праздника.	Inland waterways can be a good theme to base a holiday around.
Например, посещение замков в долине Луары, долине Рейна, прогулка на круизе по достопримечательностям Дуная, или путешествие на лодке по каналу Эри.	For example visiting castles in the Loire Valley, the Rhine valley or taking a cruise to interesting cites on the Danube or boating along the Erie Canal.
Они также определяют пути для популярных пешеходных и велосипедных маршрутов.	They also define routes for popular hiking and cycling trails.
Все животные, которые первоначально прибыли на эти острова, добрались сюда вплавь, прилетели или их прибило течением.	All animals that originally arrived in the islands came here either by swimming, flying or floating.
Из-за большого расстояния от континента млекопитающие не могли добраться до туда, что делает гигантскую черепаху основным травоядным животным на Галапагосских островах.	Due to the long distance from the continent mammals were unable to make the journey making the giant tortoise the primary grazing animal in the Galapagos.
С момента прибытия человека на Галапагосские острова было завезено много млекопитающих, в том числе коз, лошадей, коров, крыс, кошек и собак.	Since the arrival of man to the Galapagos, many mammals have been introduced including goats, horses, cows, rats, cats and dogs.
Если вы посетите Арктику или Антарктику зимой, вы узнаете, что такое полярная ночь, когда солнце не поднимается над горизонтом.	If you visit the Arctic or Antarctic areas in the winter you will experience the polar night, which means that the sun doesn't rise above the horizon.
Это представляет хорошую возможность увидеть северное сияние, потому что небо будет более или менее тёмным круглые сутки.	This offers a good opportunity to see the Aurora borealis, as the sky will be dark more or less around the clock.
Так как эти районы являются малонаселенными, и, как следствие, световое загрязнение часто не является проблемой, вы также сможете наслаждаться звездами.	As the areas are sparsely populated, and light pollution therefore often not a problem, you will also be able to enjoy the stars.
